Beautiful Widgets	com.levelup.beautifulwidgets
Google Play Books	com.google.android.apps.books
SwiftKey 3 Keyboard	com.touchtype.swiftkey
Titanium Backup a?? root	com.keramidas.TitaniumBackup
Plume for Twitter	com.levelup.touiteur
HD Widgets	cloudtv.hdwidgets
Kindle	com.amazon.kindle
Kobo	com.kobobooks.android
ROM Manager (Premium)	com.koushikdutta.rommanager.license
ASTRO File Manager / Browser	com.metago.astro
Smart Keyboard PRO	net.cdeguet.smartkeyboardpro
IMDb Movies & TV	com.imdb.mobile
Movies by Flixster	net.flixster.android
PicsArt - Photo Studio	com.picsart.studio
Battery Solo Widget	net.maicas.android.batterys
MixZing Media Player	com.mixzing.basic
Retro Clock Widget	nl.jsource.retroclock.android
Unblock Me FREE	com.kiragames.unblockmefree
Bubble Blast 2	com.magmamobile.game.BubbleBlast2
Mouse	com.magmamobile.game.mousetrap
Bubble Blast !	com.magmamobile.game.BubbleBlast
Mahjong	com.nix.game.mahjong
4 in a row	com.magmamobile.game.fourinarow
Solitaire	com.magmamobile.game.Solitaire
Connect'Em	com.magmamobile.game.connectEm
Alchemy Classic	com.niasoft.alchemyclassic
Elemental - Alchemy Puzzle	com.vostu.mobile.alchemy
Angry Words (Apalabrados)	com.etermax.apalabrados.lite
Word Search	com.melimots.WordSearch
Sound Meter	kr.sira.sound
Smart Measure	kr.sira.measure
Bunny Shooter Best Free Game	com.bestcoolfungamesfreegameappcreation.bunnyshooter
Battery Saver	com.antutu.powersaver
Neon Blue GO Launcher EX Theme	com.BahagHariArts.BlueNeonGoTheme
Windows 7 GO Launcher EX Theme	com.gau.go.launcherex.theme.windows7
Move it! Free	uk.co.aifactory.moveitfree
Block Puzzle	biz.mtoy.blockpuzzle
Wallpapers HD	com.incredibleapp.wallpapershd
Cut the Rope	com.zeptolab.ctr.paid
WordSearch Unlimited Free	com.virtuesoft.wordsearch
Best Buy	com.bestbuy.android
Brain Age Game	lop.mos.dev
My Backup Pro	com.rerware.android.MyBackupPro
ADWLauncher EX	org.adwfreak.launcher
Brain Age Test  Free	brain.age.analyzer
Audible for Android	com.audible.application
LDS Gospel Library	org.lds.ldssa
Dr.Web Anti-virus Light	com.drweb
Yandex.Navigator	ru.yandex.yandexnavi
Yandex.Maps	ru.yandex.yandexmaps
Yandex.Metro	ru.yandex.metro
Endomondo Sports Tracker PRO	com.endomondo.android.pro
ADW Theme MacOS	akglo.themes.macos
Shazam Encore	com.shazam.encore.android
HD Wallpapers & Background	com.brainpub.phonedecor
Sygic: GPS Navigation	com.sygic.aura
Google Goggles	com.google.android.apps.unveil
GPS Essentials	com.mictale.gpsessentials
Force Saber of Light	pl.pawelbialecki.jedilightsaber
SoundHound	com.melodis.midomiMusicIdentifier.freemium
Brightest Flashlight Freea?¡é	goldenshorestechnologies.brightestflashlight.free
3D Digital Weather Clock	factory.widgets.ThreeDDigitalWeatherClock
Sense Analog Clock Widget	factory.widgets.SenseClock
Mp3 Music Search & Download	com.fg.mp3download
Shazam	com.shazam.android
Words of Jesus Daily Bible	uk.co.roboticode.wordsofjesus
CamScanner -Phone PDF Creator	com.intsig.camscanner
Key Ring Reward Cards	com.froogloid.kring.google.zxing.client.android
iDroid iPhone theme for GDE	com.deejay.iDroid
???¨¦??¨¨¡¥????	com.youdao.dict
Google Reader	com.google.android.apps.reader
Superuser	com.noshufou.android.su
NewsRob (Google Reader / RSS)	com.newsrob
FBReader	org.geometerplus.zlibrary.ui.android
JuiceDefender - battery saver	com.latedroid.juicedefender
Daily Ab Workout FREE	com.tinymission.dailyabworkoutfree1
MyPhoneExplorer Client	com.fjsoft.myphoneexplorer.client
MotoTorch LED	com.alford.MotoTorchLED
Color Flashlight	com.socialnmobile.flashlight
Taptu - DJ Your News	com.taptu.streams
Flipboard: Your News Magazine	flipboard.app
T-Mobile My Account	com.tmobile.selfhelp
Apps Organizer	com.google.code.appsorganizer
GO Contacts EX	com.jbapps.contactpro
GO SMS Pro	com.jb.gosms
GO SMS Pro Widget	com.jb.gosms.widget
GO Keyboard Emoji plugin	com.jb.gokeyboard.plugin.emoji
GO SMS Pro Pink Sweet theme	com.jb.gosms.theme.sweet
GO Keyboard Pink Theme	com.jb.gokeyboard.theme.pink
RunKeeper - GPS Track Run Walk	com.fitnesskeeper.runkeeper.pro
InkPad Notepad - Notes - To do	com.workpail.inkpad.notepad.notes
Color Flashlight HD LED	com.socialnmobile.hd.flashlight
AK Notepad	com.akproduction.notepad
Note Everything	de.softxperience.android.noteeverything
myAT&T	com.att.myWireless
AlarmDroid	com.splunchy.android.alarmclock
Kies air	com.samsung.swift.app.kiesair
Tape-a-Talk Voice Recorder	name.markus.droesser.tapeatalk
iris. (alpha)	com.dexetra.iris
Fast Reboot	com.greatbytes.fastreboot
SMS Backup	tv.studer.smssync
Smart App Protector(app lock)	com.sp.protector.free
A.I.type Keyboard Free	com.aitype.android
ROM Toolbox Lite	com.jrummy.liberty.toolbox
Tuner - gStrings Free	org.cohortor.gstrings
SuperSU	eu.chainfire.supersu
Gallery Lock Pro	com.morrison.gallerylock
MapMyRun GPS Running	com.mapmyrun.android2
Android System Info	com.electricsheep.asi
Advanced Task Killer Froyo	com.rechild.advancedtaskkillerfroyo
Kaspersky Mobile Security	com.kms
LED Light	jp.picolyl.led_light
WiFi Manager	org.kman.WifiManager
App 2 SD (move app to SD)	com.a0soft.gphone.app2sd
Automatic Task Killer	biz.stachibana.TaskKiller
Solar Charger	com.szlab.solarcharger
OfficeSuite Viewer 6	com.mobisystems.office
Documents To Go 3.0 Main App	com.dataviz.docstogo
Job Search	com.indeed.android.jobsearch
¨¬??¨º¦Ì-?2?¨¬?¡è-¨º¡ã?¨¬?£¤ ?¡ì?¨¬?? ¨¬¡ì?¨¬?-¨¬?? ¨¬¡ì?¨¬??¨ª????? ?2?¨¬?¡è ¨¬?¡À	net.hyeongkyu.android.incheonBus
SlideIT Soft Keyboard	com.dasur.slideit.vt.lite
SeoulBus (¨¬??¨¬???2?¨¬?¡è)	com.astroframe.seoulbus
Days Left Widget	de.leihwelt.android.daysleft
Opera Mobile web browser	com.opera.browser
Dolphin Browser	mobi.mgeek.TunnyBrowser
Boat Browser	com.boatbrowser.free
XDA-Developers	com.quoord.tapatalkxda.activity
Tapatalk Forum App	com.quoord.tapatalkpro.activity
Unified Remote	com.Relmtech.Remote
Koi Free Live Wallpaper	fishnoodle.koipond_free
Thunderstorm Free Wallpaper	fishnoodle.storm_free
Snowfall Free Live Wallpaper	fishnoodle.snowfall_free
Aquarium Free Live Wallpaper	fishnoodle.aquarium_free
Galactic Core Live Wallpaper	fishnoodle.spacescapewallpaper_free
Blue Skies Free Live Wallpaper	fishnoodle.clouds_free
Keyboard from Android 2.3	com.moo.android.inputmethod.latin.free
Simeji???Japanese Keyboard???	com.adamrocker.android.input.simeji
National Flags Quiz	net.fractalgate.android.nationalflags
aCalendar - Android Calendar	org.withouthat.acalendar
Calendar Pad	jp.ne.gate.calpad
TweetCaster Pro for Twitter	com.handmark.tweetcaster.premium
k-pop star photo wallpaper!	kr.co.mokey.mokeywallpaper_v3
MailDroid	com.maildroid
SMS Backup +	com.zegoggles.smssync
Bible	com.sirma.mobile.bible.android
MagicMarker	com.jaytronix.markermagic
Desktop VisualizeR	jp.co.bii.android.app.dskvzr
Moviefone - Movies & Showtimes	com.aol.mobile.moviefone
GasBuddy - Find Cheap Gas	gbis.gbandroid
doubleTwist Player	com.doubleTwist.androidPlayer
Gallery Lock Free (media lock)	ukzzang.android.gallerylocklite
Hide pictures - KeepSafe Vault	com.kii.safe
Vaulty Stocks	com.theronrogers.vaultypro
DIRECTV	com.directv.dvrscheduler
Slacker Radio	com.slacker.radio
MoboPlayer Codec for ARM V6VFP	com.clov4r.android.nil.armv6_vfp
Poweramp Music Player (Trial)	com.maxmpz.audioplayer
TuneIn Radio Pro	radiotime.player
Jango Radio	com.jangomobile.android
PlayerPro DSP pack	com.tbig.playerpro.soundpack
Ultimate Guitar Tabs	com.ultimateguitar.tabs
MortPlayer Music	de.stohelit.folderplayer
4shared	com.forshared
4shared Music	com.forshared.music
Skype - free IM & video calls	com.skype.raider
Last.fm	fm.last.android
MP3 Ringtone Maker	net.lucky.star.mrtm
Ringtone Maker	com.herman.ringtone
BSPlayer FREE	com.bsplayer.bspandroid.free
Glow Hockey 2	com.natenai.glowhockey2
Glow Hockey	com.natenai.glowhockey
Doodle Jump	com.realarcade.DOJ
LINE	jp.naver.line.android
QQPlayer	com.tencent.research.drop
Nimbuzz Messenger	com.nimbuzz
Pocket Legends	sts.pl
Pocket Soccer	com.rastergrid.game.pocketsoccer
Fish Live	com.baileyz.aquarium
Aqua Pets	com.bionicpanda.aquapets
MX Moto (Lite)	com.camelgames.mxmotorlite
Blow Up (Free)	com.camelgames.blowuplite
Little Empire	com.camelgames.fantasyland
Shoot U! (Lite)	com.camelgames.shootulite
ShakyTower (physics game)	com.mobillness.shakytower.full
Mobo Video Player (v5)	com.mobo.video.player.arm5
Mobo Video Player	com.mobo.video.player.arm7
Tiny Compass	com.devuni.compass
Battery HD	ch.smalltech.battery.free
Pansi SMS	com.pansi.msg
UberSocial for Twitter	com.twidroid
Smart Connect (LiveWarea?¡éMgr)	com.sonyericsson.extras.liveware
Seesmic (Facebook, Twitter)	com.seesmic
TweetDeck (Twitter, Facebook)	com.thedeck.android.app
VEVO	com.vevo
Ustream	tv.ustream.ustream
Sony Extras for Facebook	com.sonyericsson.extras.liveware.extension.facebook
iMediaShare Lite	com.bianor.ams
GO Calendar Widget	com.gau.go.launcherex.gowidget.calendarwidget
GOWidget Theme - Transparency	com.gau.go.launcherex.theme.gowidget.transparency
GO Switch Widget	com.gau.go.launcherex.gowidget.switchwidget
Cartoon Theme GO Launcher EX	com.gau.go.launcherex.theme.blue
Classic Theme GO Launcher EX	com.gau.go.launcherex.theme.classic
GO Clock Widget	com.gau.go.launcherex.gowidget.clockwidget
GO TaskManager EX	com.gau.go.launcherex.gowidget.taskmanagerex
Notification Bubbles Free	com.commind.bubbles
MagicLocker Main	mobi.lockscreen.magiclocker
FartDroid Fart Machine	com.joshuadobbs.rudedroid
Private SMS & call	com.superdroid.spc
Launcher 7	info.tikuwarez.launcher3
Uninstaller	com.rhythm.hexise.uninst
Sudoku Free	com.icenta.sudoku.ui
Barnacle Wifi Tether	net.szym.barnacle
X Construction	de.hms.xconstructionfull
Chess for Android	com.google.android.chess
Checkers Free	com.optimesoftware.checkers.free
Free Running	com.andoop.freerunning
Hotels.com a?? 150,000+ hotels	com.hcom.android
Cut the Rope: Experiments FREE	com.zeptolab.ctrexperiments.ads
Cut the Rope: FULL FREE (ads)	com.zeptolab.ctr.ads
Cut the Rope Lite	com.zeptolab.ctr.lite.google
Draw Something	com.omgpop.dstpaid
Fake-Call Me Free, Halloween	com.agilestorm.fakecall.free
PicSay - Photo Editor	com.shinycore.picsayfree
Shoot the Apple	com.droidhen.shootapple
The Moron Test: Section 1	com.distinctdev.tmtlite
Star Legends (3D MMO)	sts.sl
Air Control	dk.logisoft.aircontrolfull
Quell Reflect	com.fallentreegames.quellreflect
FxCamera	ymst.android.fxcamera
Brightness Level	com.curvefish.widgets.brightnesslevel
Jewels Maze!	com.ezjoynetwork.jewelsmaze
Jewellust	alterforce.engine
Jewels Legend	com.game.JewelsLegend
Marble Saga	com.game.MarbleSaga
Happy Street	com.godzilab.happystreet
Stardunk	com.gzl.stardunk
RealCalc Scientific Calculator	uk.co.nickfines.RealCalc
Traffic Jam Free	com.jiuzhangtech.rushhour
Coloroid	com.tapjoy.coloroid
Devil Hunter	com.ezjoynetwork.devilhunter
Angry Birds	com.rovio.angrybirds
File Expert	xcxin.filexpert
Air Penguin??	com.enterfly.penguin_gloplus
TETRIS?? free	com.ea.tetrisfree_na
The Simsa?¡é FreePlay	com.ea.games.simsfreeplay_na
SCRABBLE Free	ca.jamdat.flight.scrabblefree
Blast Monkeys	com.yobonja.blastmonkeysfree
Mega Jump	com.getsetgames.megajump
Photo Editor by Aviary	com.aviary.android.feather
Perfect Tool for Picasa	larry.zou.colorfullife
Bubble Burst Free	com.androgames.BubbleBurst
ROM Manager	com.koushikdutta.rommanager
Simple Calendar Widget	com.anod.calendar
Kids Connect the Dots Lite	zok.android.dots
Kids Numbers and Math Lite	zok.android.numbers
Bridge Architect Beta	com.reactive.bridge.beta
Jewellust lite	alterforce.jewellust_lite
Break the Bricks	com.candydroid.breakblock
Slot Machine Deluxe	com.play.slot
ScanLife Barcode & QR Reader	com.ScanLife
Toss It	com.boolbalabs.tossit.preview
MeetMe - Meet New People	com.myyearbook.m
Gauge Battery Widget	net.hubalek.android.gaugebattwidget
Save MMS	com.schwimmer.android.mmsextract
Paranormal Agency	com.g5e.paranormal
Engadget	com.aol.mobile.engadget
BBC News	bbc.mobile.news.ww
NYTimes app for phone	com.nytimes.android
Skyscanner - All Flights!	net.skyscanner.android.main
LOL Pics (Funny Pictures)	com.sphinx.lolpics
EasyMoney - Expense Manager	com.handyapps.easymoney
CWMoney Expense Track	com.lib.cwmoney
Google Finance	com.google.android.apps.finance
Battery Widget? Reborn! (BETA)	net.hubalek.android.reborn.beta
OI Shopping list	org.openintents.shopping
Zillow Real Estate & Rentals	com.zillow.android.zillowmap
YP Local Search & Gas Prices	com.yellowpages.android.ypmobile
TalkBox Voice Messenger - PTT	com.gtomato.talkbox
Pocket Auctions for eBay	com.bonfiremedia.android_ebay
USA TODAY for Phone	com.usatoday.android.news
Easy App Lock - Manager	com.easy.app.manager
Dictionary.com	com.dictionary
Cover Art Downloader	com.birbeck.android.coverart
Elements	com.magmamobile.game.Elements
Photo Grid HD	com.roidapp.photogrid
PlayerPro Music Player Trial	com.tbig.playerprotrial
Hidden Object	com.magmamobile.game.HiddenObject
Pinball	com.nix.game.pinball.free
Checkers	com.magmamobile.game.checkers
Plumber	com.magmamobile.game.Plumber
Wordfeud	com.hbwares.wordfeud.full
Smart Compass	kr.sira.compass
Twisted Colors	com.maxelus.twistedcolorslivewallpaper
Word Search Free	air.wordSearchFree
Bubble Live Wallpaper	com.xllusion.livewallpaper.bubble
Talking Tom Cat	com.outfit7.talkingtompro
iTranslate - free translator	at.nk.tools.iTranslate
Flashlight	org.dyndns.devesh.flashlight
Sense Analog Clock Widget Dark	factory.widgets.SenseClockDark
QR Droid	la.droid.qr
Do it (Tomorrow)	com.adylitica.android.DoItTomorrow
Titanium Backup PRO Key a?? root	com.keramidas.TitaniumBackupPro
gReader (Google Reader | RSS)	com.noinnion.android.greader.reader
Instant Heart Rate	si.modula.android.instantheartrate
Meridian Media Player Revolute	org.iii.romulus.meridian
OverDrive Media Console	com.overdrive.mobile.android.mediaconsole
GO SMS Pro Emoji Plugin	com.jb.gosms.emoji
ColorDict Dictionary Wikipedia	com.socialnmobile.colordict
3G Watchdog	net.rgruet.android.g3watchdog
Screen Filter	com.haxor
Mini Info Classic	com.dynotes.miniinfo
ClockSync	ru.org.amip.ClockSync
Root Explorer (File Manager)	com.speedsoftware.rootexplorer
Bluetooth File Transfer	it.medieval.blueftp
Speedtest.net	org.zwanoo.android.speedtest
Tank Recon 3D (Lite)	com.lonedwarfgames.tanks.android
StopWatch & Timer	com.sportstracklive.stopwatch
Horoscope	fr.telemaque.horoscope
TV Guide	com.roundbox.android.tvguide.presentation.activity
Hide Pictures in Vaulty	com.theronrogers.vaultyfree
Poweramp Full Version Unlocker	com.maxmpz.audioplayer.unlock
Bebbled	com.devuni.multibubbles.trial
TrackIDa?¡é	com.sonyericsson.trackid
GO Launcher EX Notification	com.gau.golauncherex.notification
Google Play Movies & TV	com.google.android.videos
Aliens Invasion	com.itreegamer.game.Aliens
Take me Home	com.hz.game.forest
Four In A Line	cn.bluesky.fourinaline
Yoo Ninja! Free	com.RunnerGames.game.YooNinja_Lite
Gold Miner	com.game.dmgoldminer
Life360 Family Locator	com.life360.android.safetymapd
Andoku Sudoku	com.googlecode.andoku
TripAdvisor Hotels Flights	com.tripadvisor.tripadvisor
Agent with free voice calls	ru.mail
Flow Free	com.bigduckgames.flow
Linda File Manager	com.lindaandny.lindamanager
Funny SMS Ringtones	com.sancronringtones.funnysmssb
Tourist language learn & speak	com.usefull.phrasestranslate
Funny Facts Free 8000+	com.srsdev.allfacts
Super Clock Wallpaper Free	mx.livewallpaper.clocklight
Shake Them All! Live Wallpaper	net.yougli.shakethemall
Google Chrome to Phone	com.google.android.apps.chrometophone
Minimalistic Text	de.devmil.minimaltext
Sports Tracker	com.stt.android
shopkick - Treat Yourself.	com.shopkick.app
Strava Cycling	com.strava
Calorie Counter - MyFitnessPal	com.myfitnesspal.android
My Days - Period & Ovulation a?¡é	com.chris.mydays
Lightning Bug - Sleep Clock	com.media1908.lightningbug
Team Stream	com.bleacherreport.android.teamstream
Domino's Pizza USA	com.dominospizza
ca?¡éMobile Craigslist Client	craigslist.pro.free
Skyfire Web Browser 4.0	com.skyfire.browser
GO Contacts	com.jbapps.contact
Yelp	com.yelp.android
US Yellow Pages	com.yellowbook.android2
Calorie Counter by FatSecret	com.fatsecret.android
iTriage Health	com.healthagen.iTriage
Cardiograph	com.macropinch.hydra.android
iQuran	com.guidedways.iQuran
SwiftKey 3 Keyboard Free	com.touchtype.swiftkey.phone.trial
Torque Pro (OBD 2 & Car)	org.prowl.torque
Cool Wallpapers HD	com.appsilicious.wallpapers
Guitar Tuner	com.resoundspot.guitartuner.lite
Espier Launcher	mobi.espier.launcher
Messenger WithYou	miyowa.android.microsoft.wlm
Taskos To Do List | Task List	com.taskos
SiMi Clock Widget	com.th.android.widget.gTabsimiClock
Beautiful Live Weather	com.levelup.beautifullive
Astrid Tasks & To-do List	com.timsu.astrid
PocketCloud Remote RDP / VNC	com.wyse.pocketcloudfree
Task Manager	com.rhythm.hexise.task
File Manager	com.rhmsoft.fm
Agenda Widget for Android	com.roflharrison.agenda
Antivirus Free	com.antivirus
SanDisk Memory Zone	com.sandisk.mz
Easy Cache Cleaner	com.bazinga.cacheclean
Super Manager 3.0	gpc.myweb.hinet.net.TaskManager
BW Animation Package	com.levelup.bw.forecast
Skitch	com.evernote.skitch
Catch Notes	com.threebanana.notes
Photo Editor - Fotolr	com.tinypiece.android.PSFotolr
Android Assistant(18 features)	com.advancedprocessmanager
Solid Explorer Beta2	pl.solidexplorer
FVD - Free Video Downloader	it.tolelab.fvd
D?????D3D?D?Do????D3 - D¡ä????D¡¤???? ????D¡äD?D?	drug.vokrug
VKontakte	com.vkontakte.android
exDialer	com.modoohut.dialer
K-9 Mail	com.fsck.k9
MoreLocale 2	jp.co.c_lis.ccl.morelocale
Yahoo! Messenger Plug-in	com.yahoo.mobile.client.android.imvideo
Free SMS India	util.sms
AudioManager	com.smartandroidapps.audiowidget
Offline dictionaries	fr.nghs.android.dictionnaires
SetCPU for Root Users	com.mhuang.overclocking
tTorrent Lite - Torrent Client	hu.tagsoft.ttorrent.lite
Farm Tower HD	org.anddev.farmtower.eco
Big Sport Fishing 3D Lite	com.rocketmind.fishing
WhatsApp Messenger	com.whatsapp
Jasmine IM	ru.ivansuper.jasmin
HD Full Screen Caller ID	tw.nicky.HDCallerID
CamCard Lite - Business Card R	com.intsig.BCRLite
Screen Off and Lock	com.katecca.screenofflock
Android Lost Free	com.androidlost
ANT Radio Service	com.dsi.ant.service.socket
Tagged - Meet New People	com.taggedapp
Emoji Keyboard	com.klncity1.emojikeyboard
ezPDF Reader PDF Annotate Form	udk.android.reader
AirPush Detector	com.brosmike.airpushdetector
Screen Crack	com.laan.toys
Scanner Radio	com.scannerradio
Shush!	com.publicobject.shush
Call Filter	jp.co.telemarks.CallFilter2
Netflix	com.netflix.mediaclient
A Comic Viewer	net.androidcomics.acv
Sketch Free	com.topnet999.android.sketch
OI File Manager	org.openintents.filemanager
Spare Parts Plus! (no ads)	com.droidgram.spareparts
MOG Mobile Music	com.mog.android
ICQ: Free Voice Calls,Messages	com.icq.mobile.client
WidgetLocker Lockscreen	com.teslacoilsw.widgetlocker
Firefox	org.mozilla.firefox
Where's My Water? Free	com.disney.WMWLite
Where's My Water?	com.disney.WMW
Wordfeud FREE	com.hbwares.wordfeud.free
Mr. Block Free	com.Wuzla.game.Block_AD
Smart Tools	kr.aboy.tools
HELP OUT - Blocks Game	com.incredibleapp.helpout
Noom Weight Loss Coach	com.wsl.noom
Pizza Hut	com.yum.pizzahut
Zoner AntiVirus Free	com.zoner.android.antivirus
Android Music Player	com.jrtstudio.music
Gmail	com.google.android.gm
Emojiba : cute emoticons!	com.beyond.emojiba
YouTube	com.google.android.youtube
Facebook Messenger	com.facebook.orca
ScoreMobile: Sports & Scores	com.fivemobile.thescore
reddit is fun	com.andrewshu.android.reddit
Go!Chat for Facebook	com.spartancoders.gtok
The Weather Channel	com.weather.Weather
WeatherPro	com.mg.android
Instagram	com.instagram.android
Maps	com.google.android.apps.maps
LinkedIn	com.linkedin.android
Orkut	com.google.android.apps.orkut
Google Translate	com.google.android.apps.translate
One Touch Battery Saver	cn.menue.batterysave.international
Quadrant Standard Edition	com.aurorasoftworks.quadrant.ui.standard
Badoo - Meet New People	com.badoo.mobile
Google Search	com.google.android.googlequicksearchbox
SoundCloud	com.soundcloud.android
WordPress	org.wordpress.android
??¡è¨¬?¡ä?2? ??????¨º¡¤? - Naver Blog	com.nhn.android.blog
TiKL Touch Talk Walkie Talkie	mobi.androidcloud.app.ptt.client
Camera ZOOM FX	slide.cameraZoom
QuickMark Barcode Scanner	tw.com.quickmark
Little Photo	com.littlephoto
GameFly	com.gamefly.android.gamecenter
BatteryTime Lite	com.motalen.batterytimelite
HeyTell	com.heytell
Easy Tether Lite (CE)	com.mstream.easytether_beta
SoundHound a??	com.melodis.midomiMusicIdentifier
Photo Warp	hu.tonuzaba.android
FML Official	fmlife.activities
Call Confirm	net.nanabit.callconfirm
Grindr - Gay, bi & curious guy	com.grindrapp.android
BoyAhoy - Gay Chat	com.boyahoy.android
Gay Chat & Dating - Jack'd	mobi.jackd.android
Glympse	com.glympse.android.glympse
DIGI Clock Widget	sk.michalec.SimpleDigiClockWidget
Sound Effects Ringtones	com.aura.ringtones.aurasoundeffects
Christmas Countdown Kids Story	com.dancingsquirrel.elf
Alarm Clock Plusa?	com.vp.alarmClockPlusDock
Zlango Messaging	com.zlango.zms
sms Blocker - AWARD WINNER	com.smsBlocker
Battery Widget	com.geekyouup.android.widgets.battery
Google Play Music	com.google.android.music
Maxthon Android Web Browser	com.mx.browser
Hotmail	com.hotmail.Z7
Music Volume EQ	hr.podlanica
Volume Control +	com.cb.volumePlus
Craigslist Mobile	com.duduapps.craigslistfree
Google Earth	com.google.earth
MyPeople	net.daum.android.air
KakaoStory	com.kakao.story
ooVoo Video Call	com.oovoo
Talking Babsy Baby	com.kauf.talking.baum.TalkingBabsyBaby
Relax and Sleep	com.mizusoft.relaxandsleep
Textfree: Text Free, Free SMS	com.pinger.textfree
Fontomizer SP	com.hongik.fontomizerSP
AutoKiller Memory Optimizer	com.rs.autokiller
iStoryBooks	com.infomarvel.istorybooks
Notes	com.android.demo.notepad3
Google Korean IME	com.google.android.inputmethod.korean
Wise Proverbs Daily Bible	uk.co.roboticode.wiseproverbs
Prayers & Blessings Daily	uk.co.roboticode.prayersandblessings
My Horoscope	com.idmobile.horoscope
Bible KJV	com.gyc.ace.kjv
Amazon Mobile	com.amazon.mShop.android
Amazon MP3	com.amazon.mp3
Shadow Galaxy	com.maxelus.shadowgalaxylivewallpaper
Ice Galaxy	com.maxelus.icegalaxylivewallpaper
Vortex Galaxy	com.maxelus.vortexgalaxylivewallpaper
Inferno Galaxy	com.maxelus.infernogalaxylivewallpaper
Christmas Tree Live Wallpaper	proscio.wallpaper.christmastree
Hungry Shark 3 Free!	com.fgol.sharkfree3
Hungry Shark Free!	com.fgol.sharkfree
BUG VILLAGE	com.glu.android.bugvillage
LadyBug	com.donxu.lady_bug
Angry Birds Space Premium	com.rovio.angrybirdsspace.premium
Skater Boy	com.game.SkaterBoy
Devil Ninja 2	com.droidstudio.game.devil2
Diversion	com.ezone.Diversion
Ninja Chicken	mominis.Generic_Android.Ninja_Chicken
MiniGame Paradise	com.com2us.minigameparadise.normal.freefull.google.global.android.common
Wikipedia	org.wikipedia
WikiMobile (Wikipedia Browser)	com.bonfiremedia.android_wikimobile
Special Enquiry Detail	com.g5e.specialenquiry
???¨º¦Ì?¨¬?¡ã ¨ª??¨¬?¡è¨ª??	ss.ga.jess
AdFree Android	com.bigtincan.android.adfree
¨¬¡ì?¨ª??¨¬2? ¨¬¡é?¨º2¡ã¨¬?? : Smarter Subway	teamDoppelGanger.SmarterSubway
Korea Subway Information	com.vtron.subway
Snowflakes Live Wallpaper Free	chris.cooper.snowflakes
Sun Rise Free Live Wallpaper	com.teragon.skyatdawnlw.lite
Backgrounds HD Wallpapers	com.stylem.wallpapers
Air Hockey Speed	com.hyperkani.airhockey
Spaghetti Marshmallows Lite	com.fiffigt.spaghetti.lite
Dolphin Browser?? Mini	com.dolphin.browser
GRave Defense HD Free	com.artofbytes.gravedefence.hd.free
Opera Mini web browser	com.opera.mini.android
Opera Mini Next web browser	com.opera.mini.next.android
Aldiko Book Reader	com.aldiko.android
Windows7 Theme for GDE	com.deejay.Win7
WhatsApp Wallpaper	com.whatsapp.wallpaper
The Matrix - Live Wallpaper	simosoftprojects.matrixlivewallpaper
¨¬??¨¬?¡ä??¡ê¨º?¡ã¨ª??¨º¡ã? ¨ª??¨¬?¡ã¨ª???|?¨¬?¡§	com.howtolisten.main
Android 2.3 Launcher (Home)	com.moo.android.launcher.gingerbread
How to Tie a Tie	com.artelplus.howtotie
Zello Walkie Talkie	com.loudtalks
Battery widget Z	com.zang.app.BatteryZ
Drag Racing	com.creativemobile.DragRacing
GT Racing: Motor Academy Free+	com.gameloft.android.ANMP.GloftGTFM
Smart AppLock (App Protector)	com.thinkyeah.smartlockfree
Best Wallpaper HD Pro	com.best.wallpaper.background.hd
Heyzap	com.heyzap.android
Rage Comic Maker	com.tmarki.comicmaker
Talking Roby Celik Free	com.outfit7.talkingrobyfree
Mole!Mole!!Mole!!!	jp.co.sic.PokeAMole
My docomo checker	jp.meloncake.mydocomo
SpeechSynthesis Data Installer	com.svox.langpack.installer
Kingsoft Office (Free)	cn.wps.moffice_eng
Droidlight LED Flashlight	com.motorola.dlight
Smart SWF Player- Flash Viewer	com.andy.flash
ConnectBot	org.connectbot
Earth Live Wallpaper	com.seb.SLWP
Storm (Live wallpaper)	name.galley.android.wallpapers.storm
BatteryLife	com.curvefish.batterylife
WiFi OnOff	com.curvefish.widgets.wifionoff
SilentMode OnOff	com.curvefish.widgets.silentmodeonoff
Skyvi (Siri for Android)	com.bluetornadosf.smartypants
Vlingo Virtual Assistant	com.vlingo.client
Lock Screen Widget	com.droidmania.lockscreenwidget
Musical Piano FREE	souvey.musical
Trulia Real Estate & Rentals	com.trulia.android
Cloud Print	com.pauloslf.cloudprint
Everfriends a?? Voice Assistant	com.ifree.everfriends
ConvertPad - Unit Converter	com.mathpad.mobile.android.wt.unit
Mobile Andrio (Free)	de.joergjahnke.mario.android.free
WomanLog Calendar	com.womanlog
OnlineZeitungen Deutschland	eduardoremar.onlinezeitungen
Logo Quiz	logos.quiz.companies.game
Two Million (Quiz)	boyansoft.bogmix.en.millionaire
Uplifting Psalms Daily Bible	uk.co.roboticode.upliftingpsalms
Identity in Christ Daily Bible	uk.co.roboticode.identityinchrist
Dropwords	com.eekgames.worddrop
Bible	com.faithcomesbyhearing.android.bibleis
NBA Game Time 2012-13	com.nbadigital.gametimelite
NFL '12	com.gotv.nflgamecenter.us.lite
GMX Mail	de.gmx.mobile.android.mail
xPiano	com.cyandroid.piano
My Piano	com.bti.myPiano
DiskUsage	com.google.android.diskusage
AppBrain App Market	com.appspot.swisscodemonkeys.apps
Handcent Emoji Plugin	com.handcent.plugin.emoji
IKEA Catalogue	com.ikea.catalogue.android
Handcent SMS	com.handcent.nextsms
Handcent Font Pack5	com.handcent.fontpack.pack5
HistoryEraser	jp.androdev.historyeraser
2x Battery - Battery Saver	com.a0soft.gphone.aDataOnOff
??¡è¨¬?¡ä?2? - Naver	com.nhn.android.search
G-News	name.galley.android.web.googlenewsregion
UK & World News	net.jimblackler.newswidget
Talking Santa Free	com.outfit7.talkingsantafree
FOX News	com.foxnews.android
Stitcher Radio - News & Talk	com.stitcher.app
Starbucks	com.starbucks.mobilecard
Easy Downloader	com.et.easy.download
XPERIA FlashLight	jp.co.telemarks.ledlightx10
AlloCine	com.allocine.androidapp
handyCalc Calculator	org.mmin.handycalc
Digital Clock Widget	com.maize.digitalClock
WebMD for Android	com.webmd.android
Talking Ben the Dog Free	com.outfit7.talkingben
Akinator the Genie	com.digidust.elokence.akinator.paid
Ultra Voice Changer	com.kimusoft.voice_changer_chipmunk
Talking Pierre the Parrot Free	com.outfit7.talkingpierrefree
SAMURAI vs ZOMBIES DEFENSE	com.glu.samuzombie
Drago Pet	eu.aagames.dragopet
SpeedView: GPS Speedometer	com.codesector.speedview.free
1Tap Cleaner	com.a0soft.gphone.acc.free
aTrackDog - track new version	com.a0soft.gphone.aTrackDog
BusyBox	stericson.busybox
AutoCAD WS	com.autodesk.autocadws
HBO GO	com.HBO
Poynt	com.poynt.android
Gallery Lock	com.morrison.gallerylocklite
NoLED	com.led.notify
Compass	com.apksoftware.compass
My Xbox LIVE	com.microsoft.xle
Download All Files	com.hwkrbbt.downloadall
Palringo Group Messenger	com.palringo.android
Myspace	com.myspace.android
XING	com.xing.android
Mercury Messenger (Free)	im.mercury.android
TV Listings for Android TV24	usa.jersey.tvlistings
Photobucket Mobile	com.photobucket.android
PicSay Pro - Photo Editor	com.shinycore.picsaypro
Redbox	com.redbox.android.activity
Network Signal Speed Booster a?	com.freshnetwork
OpenSignalMaps	com.staircase3.opensignal
Hindi & Bollywood Songs- Saavn	com.saavn.android
Real Sex Stories	com.aphrodisiac
Beautiful Battery Disc	pl.thalion.mobile.battery
GTunes Music Download V8	com.newgt.gtmusic
GO Weather EX	com.gau.go.launcherex.gowidget.weatherwidget
Back Talk Free	com.csi.backtalkfree
AIM	com.aol.mobile.aim
Pho.to Lab	vsin.t16_funny_photo
Paper Camera	com.dama.papercamera
Camera Fun Free	com.spiceloop.camerafunfree
PhotoShake!	com.motionone.photoshake
DECOPIC,Kawaii PhotoEditingApp	com.cfinc.decopic
Angry? Unlock Your Birds!	com.great.android.apps.angry.birds.unlocker.golden.eggs.three.stars
Photo Art - Color Effects	com.funfactory.photoeditor
wp clock design live wallpaper	com.tomanyz.lockWatchLight
Digi Clock	com.sonyericsson.digitalclockwidget
Pixlr-o-matic	pixlr.OMatic
SketchBook Mobile Express	com.sketchbookexpress
VidTrim - Video Trimmer	com.goseet.VidTrim
Radio Record	com.infoshell.recradio
Quran Android	com.quran.labs.androidquran
Quran	com.amir.coran
Horoscopes	com.dailyhoroscopes.net
SPB TV	com.spb.tv.am
Audiogalaxy Music	com.audiogalaxy
Power Manager	com.acme.android.powermanager
Paltalk Video Chat	com.paltalk.chat.android
fring	com.fring
MyMusicOn Music Player	com.evonit.mymusicon
LauncherPro	com.fede.launcher
Zimly the Coolest Media Player	com.nomad.zimly
SpeedCar	Game.NDK
Tap Tap Revenge 4	com.tapulous.taptaprevenge4
Zombie Lane	com.dchoc
Ringdroid	com.ringdroid
n7player Music Player	com.n7mobile.nplayer
Music Folder Player Free	de.zorillasoft.musicfolderplayer
Slot Machine	com.apostek.SlotMachine
Roulette Royale	com.mw.rouletteroyale
Paper Toss	com.bfs.papertoss
Pocket Empires Online	com.miracle.android.pe
iMobstersa?¡é - 12 Favor Points	com.storm8.imobsters12
Bubble Blast Valentine	com.magmamobile.game.BubbleBlastValentine
Minecraft - Pocket Edition	com.mojang.minecraftpe
Bubble Blast Halloween	com.magmamobile.game.BubbleBlastHalloween
World Clock & Widget	tm.app.worldClock
Pocket Frogs	com.mobage.ww.a435.pocketfrogs_android
Bubble Blast Easter	com.magmamobile.game.BubbleBlastEaster
Mystery of the Crystal Portal	com.g5e.crystalportal
Mahjong 3D	com.magmamobile.games.mahjong3D
Pinball Deluxe	com.greencod.pinball.android
Solitaire	com.mobilityware.solitaire
Spider Solitaire	com.mobilityware.spider
Solitaire	com.kmagic.solitaire
250+ Solitaire Collection	com.anoshenko.android.solitaires
MatchUp : Exercise your Memory	com.magmamobile.game.MatchUp
Push Roll	com.magmamobile.game.pushroll
PhotoWall Live Wallpaper	com.larvalabs.photowall
Alchemy Classic HD	com.niasoft.alchemyclassichd
Alchemy ~ Genetics	com.creativem.geneticsfull
Drag Racing: Bike Edition	com.creativemobile.dragracingbe
Basketball Shots  3D	com.sas.basketball
X Construction Lite	de.hms.xconstruction
Greedy Spiders Free	com.blyts.greedyspiders.free
SlideIT Keyboard	com.dasur.slideit
Math Workout	com.akbur.mathsworkout
Scramble With Friends Free	com.zynga.scramble
Scramble With Friends	com.zynga.scramble.paid
Dream Zoo	com.zynga.dreamzoo
Dream Heights	com.zynga.dreamheights
Ayakashi: Ghost Guild	com.zynga.zjayakashi
7 Little Words	com.blueoxtech.sevenlittlewords
ZombieSmash	com.zynga.zombiesmash
Tip Calculator by TradeFields	com.istockmanager
Word Breaker (Cheat 4 Friends)	com.firecrackersw.wordbreaker
Hangman	com.spice.hangman
Hangman Classic Free	com.virtuesoft.android.hangman
Triple Town	com.spryfox.tripletown
Cool Reader	org.coolreader
Who Becomes Rich (Trivia Quiz)	de.sellfisch.android.wwr
Grand Theft Auto III	com.rockstar.gta3
Noogra Nuts	com.bengigi.noogranuts
Lane Splitter	com.fractiv.lanesplitter
Quick Settings	com.bwx.bequick
Galaxy	com.magmamobile.game.Galaxy
City Jump	com.droidhen.game.superman
Froggy Jump	org.invictus.froggyjumpx
NinJump	com.bfs.ninjump
PapiJump	net.sunflat.android.papijump
Flying Penguin  best free game	com.topfreegames.penguinfree
Crime Story	com.gameinsight.crimestory
Metal Detector	com.imkurt.metaldetector
Alert Terrorist FREE	org.fankong
Music Hero	com.wordsmobile.musichero
Perfect Piano	com.gamestar.pianoperfect
Dante: THE INFERNO game - FREE	com.javaground.danteinferno
Office Jerk Free	com.fluik.OfficeJerkFree
iBeer FREE	com.hottrix.ibeerfree
Bottle Shoot	com.droidhermes.bottleninja
Go-Go-Goat!	com.bestcoolfungamesfreegamecreation.gogogoat
Fireworks	com.bestcoolfungamesfreegameappcreation.fireworksgame
Coloring Book	pl.ayground.coloringbook
Pumpkins vs. Monsters	com.RunnerGames.game.PumpkinsVsMonster_AD
Angry Birds Seasons	com.rovio.angrybirdsseasons
JuiceDefender Ultimate	com.latedroid.ultimatejuice
Kids Animal Piano Free	com.androidcave.animalpiano.free
Equalizer	com.smartandroidapps.equalizer
TTPod	com.sds.android.ttpod
Pool Break Lite	com.kb.Carrom3D
Screenshot UX Trial	com.liveov.shotuxtrial
Falldown Classic	com.teamsoft.falldown
BreakTheBlocks Lite	com.snctln.game.BreakTheBlocks
ColorNote Notepad Notes To Do	com.socialnmobile.dictapps.notepad.color.note
Tip-Off Basketball	com.iopixel.basketball2
Rule the Sky	com.jce.RuleTheSky
Fruit Slice	com.droidhen.fruit
Fruit Ninja Free	com.halfbrick.fruitninjafree
Nexus Revamped Live Wallpaper	com.stealthcopter.nexusrevamped
Dark Legends	sts.dl
Homerun Battle 3D FREE	com.com2us.HB3DLITE
Warspear Online	com.aigrind.warspear
Earth And Legend	com.dvidearts.earthandlegend
Farm Storya?¡é	com.teamlava.farmstory
Fairy Farm	com.fairyfarmgame
Tiny Farm??	com.com2us.tinyfarm.normal.freefull.google.global.android.common
Pocket Goda?¡é	com.ngmoco.pocketgod
Highway Rider	com.batteryacid.highwayrider
Restaurant Storya?¡é	com.teamlava.restaurantstory
Fish Adventure	com.socialin.android.game.fishadventure
Bird Land 2.0	com.socialin.android.game.birdlandnew
Virtual Families Lite	com.ldw.android.vf.lite
Rage of Bahamut	com.mobage.ww.a692.Bahamut_Android
Zombie Farm	com.mobage.ww.a465.zombiefarm_android
Blood Brothers (RPG)	com.mobage.ww.a759.Blood_Brothers_Android
Ninja Action RPG: Ninja Royale	com.mobage.ww.a467.TapSlashNinja_Sandbox
Tiny Tower	com.mobage.ww.a560.tinytower_android
We Rule	com.mobage.ww.a429.Kingdoms_Android
Tap Pet Hotel	com.pocketgems.android.tappethotel
Miracle City	com.droidhen.game.mcity
Fishin' 2 Go (LITE)	com.cyxb.fishin2go_lite
Multicon Widget	com.h9kdroid.multicon
Tap Zoo	com.pocketgems.android.tapzoo
DEAD TRIGGER	com.madfingergames.deadtrigger
PrinterSharea?¡é Mobile Print	com.dynamixsoftware.printershare
Farm Frenzy Lite	com.herocraft.game.farmfrenzylite
Castle Of Shadows	com.zhanyao4Main
Robotek	net.hexage.robotek.hd
Moto X Mayhem Free	com.occamy.android.motoxmayhem1lite
Bubble Shooter	com.game.BubbleShooter
Jewels	org.mhgames.jewels
Wheelz - Free Edition	com.chozabu.android.LightBikeGame
Roller Ball	com.wordsmobile.RollerBall
Ball-Hop Bowling	com.RenownEntertainment.BallHop
Tiny Village	com.tinyco.village
Shoot Bubble Deluxe	com.shootbubble.bubbledexlue
Tangram HD	com.jin.games.tangram
Airport City	com.gameinsight.airport
AirAttack HD Lite	com.ArtInGames.AirAttackHDLite
Tom's Love Letters	com.outfit7.tomslovelettersfree
Ninja slash FireBall	com.ielfgame.fireBall
Speed Skater	com.incrementalsoft.SkaterIsBack
Helidroid 3D : Helicopter RC	com.heuer.helidroid
Slice It!	com.com2us.sliceit
LINE Card	jp.naver.linecard.android
LINE Birzzle	jp.naver.sklinebirzzle
Vault-Hide SMS, Pics & Videos	com.netqin.ps
Link It Lite	com.boolbalabs.linkit
Smiley Pops	com.boolbalabs.smileypops
Birzzle	com.enfeel.birzzle
Game Dev Story	net.kairosoft.android.gamedev3en
Tiny Zoo Friends	com.tinycorp.tinyzoo.android
MovieStarPlanet	air.MSPMobile
Subway Surfers	com.kiloo.subwaysurf
FLV Video Player	air.br.com.bitlabs.FLVPlayer
GUN BROS MULTIPLAYER	com.glu.android.gunbros_free
Angry Piggy	com.piggyadventure.game.top.best.free
Speed Anatomy Quiz Free	com.speedAnatomy.speedAnatomyLite
FatBooth	com.piviandco.fatbooth
Monster Galaxy	com.gaiaonline.monstergalaxy
Cut'n'Roll	com.genina.android.cutnroll
Real BlackJack	com.genina.android.blackjack.view
Lair Defense: Shrine	com.hz.game.ld2
Dragon, Fly! Free	com.lsgvgames.slideandfly
Cut and Slice	com.cutslice
AppMonster Free Backup Restore	de.android_telefonie.appmanager
Fish Tank 3d Live Wallpaper	com.fishtank3dlivewallpaper.rainbowapp
Learn English with busuu.com!	com.busuu.android.enc
Dictionary - Merriam-Webster	com.merriamwebster
Flashlight LED Genius	com.idmobile.flashlight
ROM Toolbox Pro	com.jrummy.liberty.toolboxpro
Sticky Note	com.ap.WidgetTest
Money Lover - Expense Manager	com.bookmark.money
Furdiburb - Beta	com.sheado.lite.pet
iMobstersa?¡é	com.storm8.imobsters
CONTRACT KILLER	com.glu.android.ck
Silent Camera	soft.kinoko.SilentCamera
Gmote 2.0	org.gmote.client.android
Brilliant Quotes & Quotations	lammar.quotes
Vignette Demo	uk.co.neilandtheresa.VignetteNewDemo
Bartender	com.android.bartender
Period Tracker	com.period.tracker.lite
Nightfall Live Wallpaper Free	com.driftwood.wallpaper.nightfall.free
Lucky Star Live Wallpaper Free	com.driftwood.wallpaper.moonbun.free
Push Ups pro	com.northpark.pushups
Push Ups	com.rittr.pushups
The Avengers Live Wallpaper	com.cellfish.livewallpaper.marvel_avengers
AirDroid	com.sand.airdroid
LiveProfile	com.liveprofile.android
Marble Blast 2	com.ezjoynetwork.marbleblast2
Ant Smasher, Best Free Game	com.bestcoolfungames.antsmasher
Zynga Poker	com.zynga.livepoker
Slots by Zynga	com.zynga.slots.free
Rocka Bowling 3D	com.bestcoolfungamesfreegameappcreation.rockabowling
APP Lock	com.domobile.applock
LINE camera	jp.naver.linecamera.android
Free Dictionary Org	org.freedictionary
50 languages	com.goethe.f50languages
Memory Trainer	org.urbian.android.games.memorytrainer
GalaxyS GO Launcher EX Themes	com.gau.go.launcherex.theme.GalaxySTheme
WeChat	com.tencent.mm
?????oQQ2012 (¨¨?a????1?¨¨????¡¥?????¡§??¡ã???¨¦?¡é?????¦Ì¨¦????????)	com.tencent.mobileqq
Fireworks Live Wallpaper	org.jaeger.wallpaper.fireworks
Navitel Navigator	com.navitel
Radardroid Lite International	com.ventel.android.radardroid.lite
Waze social GPS traffic & gas	com.waze
QIWI Wallet	ru.mw
Poweramp Standard Widget Pack	com.maxmpz.audioplayer.widgetpack1
?3	org.abrantix.rockon.rockonnggl
GO Locker 3D Worm Theme	com.jiubang.goscreenlock.theme.bug
aniPet Aquarium LiveWallpaper	com.anifree.anipet.aquarium.ad
Honeycomb GO Launcher EX Theme	no.urtegata.go_theme_honeycomb
GO SMS Pro Theme Maker plug-in	com.jiubang.gosms.wallpaperplugin
Zeam Launcher	org.zeam
Dark Summoner	com.darksummoner
AndroZip File Manager	com.agilesoftresource
10???¨¬?¡ä??¡ä ??????¨ª??¨¬??! ¨¬??????????? - ????2???? ¨¬?¡À	kr.co.appdisco.adlatte
OVEY	com.idincu.ovey.android
mixi	jp.mixi
Tom Loves Angela	com.outfit7.tomlovesangelafree
Talking Tom Cat Free	com.outfit7.talkingtom
Talking Tom & Ben News Free	com.outfit7.talkingnewsfree
Tom's Messenger	com.outfit7.tomsmessengerfree
???????????????¨¦??????-?9000+	me.chatcast.kaomoji
Layar	com.layar
DocumentsToGo Full Version Key	com.dataviz.docstogoapp
LOL?¡ã¡À¨º3?¨¬??¨¬??	com.bigstar.lolkor
Whoopee Cushion!  ( fart )	com.foncannoninc.wc
Instant Buttons	com.cremagames.instant
Disco Lighta?¡é LED Flashlight	com.discolight
FlashLight	com.android.flashLight
Air Horn!	com.foncannoninc.airhorn
Tasker	net.dinglisch.android.taskerm
TextCutie -Instagram text	com.csms.activities
World Weather Clock Widget	org.satok.gweather
GO Keyboard	com.jb.gokeyboard
Smart Keyboard Trial	net.cdeguet.smartkeyboardtrial
Business Calendar Free	netgenius.bizcal
Ringtone Maker	com.mobile17.maketones.android.free
DailyHoroscope	info.androidz.horoscope
Retro Camera	org.urbian.android.tools.vintagecam
Android Updates, News & Apps	com.drippler.android.updates
Fancy Widgets	com.anddoes.fancywidgets
3D Bowling	com.threed.bowling
Crackle - Movies & TV	com.gotv.crackle.handset
Assaulter and Metal Slugs	com.cwa.playphone.fankongqibing
Super Stickman Golf	com.noodlecake.ssg
Fandango Movies	com.fandango
OfficeSuite Pro 6 + (PDF & HD)	com.mobisystems.editor.office_registered
MoboPlayer	com.clov4r.android.nil
mVideoPlayer	afzkl.development.mVideoPlayer
RealPlayer??	com.real.RealPlayer
PlayerPro Music Player	com.tbig.playerpro
Rhapsody	com.rhapsody
Zebra Paint	com.dornbachs.zebra
Tap Fish	com.bayview.tapfish
Spark	com.diotasoft.spark
Soul Movie	com.soludens.movieview
Tiny Flashlight + LED	com.devuni.flashlight
Flashlight HD LED	ch.smalltech.ledflashlight.free
Mobo Video Player Pro	com.mobo.video.player.pro
Flashlight	com.intellectualflame.ledflashlight.washer
GO Launcher EX	com.gau.go.launcherex
Ice Cream Sandwich (theme)	kov.theme.ics
Four In A Line Free	uk.co.aifactory.fialfree
Sudoku Free	uk.co.aifactory.sudokufree
Chess Free	uk.co.aifactory.chessfree
Reversi Free	uk.co.aifactory.rrfree
Checkers Free	uk.co.aifactory.checkersfree
Backgammon Free	uk.co.aifactory.backgammonfree
?????oQQ2011	com.tencent.qq
Go Free	uk.co.aifactory.gofree
Wherea??s My Perry? Free	com.disney.WMPLite
Pirates of the Caribbean	com.disney.PirateWars
Draw Something Free	com.omgpop.dstfree
Cut the Rope: Experiments	com.zeptolab.ctrexperiments.google.paid
AndFTP (your FTP client)	lysesoft.andftp
Fing - Network Tools	com.overlook.android.fing
World of Goo	com.twodboy.worldofgoofull
The Moron Test	com.distinctdev.tmt
Regina 3D Launcher	com.nemustech.regina
Jewels Star	com.game.JewelsStar
Unblock It  - Free	com.puissantapps.unblockit.free
Android Terminal Emulator	jackpal.androidterm
Kids Preschool  Puzzle Lite	zok.android.shapes
ShopSavvy Barcode Scanner	com.biggu.shopsavvy
The Coupons App	thecouponsapp.coupon
Sticky Blocks Free	uk.co.aifactory.stickyblocksfree
RedLaser Barcode & QR Scanner	com.ebay.redlaser
Move the Box	ua.co.cts.sideup
Expense Manager	com.expensemanager
Out of Milk Shopping List	com.capigami.outofmilk
Groupon - Daily Deals, Coupons	com.groupon
Official eBay Android App	com.ebay.mobile
Barcode Scanner	com.google.zxing.client.android
Holo Launcher	com.mobint.hololauncher
ADW.Launcher	org.adw.launcher
Urban Dictionary	com.citc.ud
CYANOGEN GO Launcher EX Theme	com.gau.go.launcherex.theme.cyanogen
Zedge	net.zedge.android
PicSpeed HD Wallpapers 300,000	com.srsdev.wallpapers
runtastic PRO	com.runtastic.android.pro2
MapMyRide GPS Cycling Riding	com.mapmyride.android2
Recipe Search	com.mufumbo.android.recipe.search
Workout Trainer	com.skimble.workouts
My Tracks	com.google.android.maps.mytracks
runtastic	com.runtastic.android
JEFIT - Workout,Fitness,GymLog	je.fit
GTasks: To Do List | Task List	org.dayup.gtask
Appreciate: Apps with Friends	com.triapodi.apprec
Jorte Calendar	jp.co.johospace.jorte
Lookout Security & Antivirus	com.lookout
Evernote	com.evernote
Adobe AIR	com.adobe.air
Adobe Photoshop Express	com.adobe.psmobile
Swing Shot	com.com2us.monkeybattle.normal.freefull.google.global.android.common
9 Innings: Pro Baseball 2011	com.com2us.nipb2011.adfree.google.global.android.common
Tower Defense??	com.com2us.towerdefense.normal.freefull.google.global.android.common
Ovenbreak	com.com2us.ovenbreak.normal.freefull.google.global.android.common
SummitX Snowboarding	com.com2us.summitxsnowboard.normal.tryandbuy.google.global.android.common
Inotia 4	com.com2us.inotia4.normal.freefull.google.global.android.common
Movies HD	com.hd.peliculashd
Dropbox	com.dropbox.android
Dictionary	com.tfd.mobile.TfdSearch
Google Gesture Search	com.google.android.apps.gesturesearch
Google Voice	com.google.android.apps.googlevoice
Dialer One	kz.mek.DialerOne
ZDbox (All-In-One toolbox)	com.zdworks.android.toolbox
Mancala	com.xoise.mancala
Battery Indicator	com.darshancomputing.BatteryIndicator
AndExplorer	lysesoft.andexplorer
Wifi Connecter Library	com.farproc.wifi.connecter
Wifi Analyzer	com.farproc.wifi.analyzer
100 Rooms	com.mpisoft.rooms
TweetCaster for Twitter	com.handmark.tweetcaster
Friendcaster for Facebook	uk.co.senab.blueNotifyFree
CBS SportCaster	com.handmark.sportcaster
Friendcaster Pro for Facebook	uk.co.senab.blueNotify
1Weather Local Radar Hurricane	com.handmark.expressweather
AnTuTu Benchmark	com.antutu.ABenchMark
twicca	jp.r246.twicca
Twitter	com.twitter.android
Facebook	com.facebook.katana
HootSuite (Twitter & Facebook)	com.hootsuite.droid.full
Crazy Snowboard	com.ezone.Snowboard
Advanced Task Killer	com.rechild.advancedtaskkiller
Advanced Task Manager	mobi.infolife.taskmanager
FoxFi (WiFi Tether w/o Root)	com.foxfi
Google+	com.google.android.apps.plus
SayHi - Find People Nearby!	com.unearby.sayhi
PdaNet	com.pdanet
Fruit Roll	com.fruitroll.game.top.best.free
Alarm Clock Xtreme Free	com.alarmclock.xtreme.free
Free Zone WiFi	net.alouw.alouwCheckin
KakaoTalk Free Calls & Text	com.kakao.talk
Viber : Free Calls & Messages	com.viber.voip
Daily Bible	joansoft.dailybible
Season Zen Free	com.dualboot.apps.springzenfree
Extreme Road Trip	ca.roofdog.roadtrip
Live BlackJack	com.dragonplay.blackjack
Live BlackJack 21	eu.mvns.games
Soccer Kicks	com.wordsmobile.soccerkicks
Pinball Pro	com.PinballGame
Tilt Racing	com.zz.thumbracing
Moon Chaser	com.reverie.game.ninja
Empire War - Full Ver.	com.bicore.empirefullggk
Easy Uninstaller	mobi.infolife.uninstaller
History Eraser	mobi.infolife.eraser
Battery Defender-Battery Saver	mobi.infolife.batterysaver
App2SD - Save phone storage	mobi.infolife.app2sd
iTag - Music Tag Editor	mobi.infolife.itag
ES File Explorer  File Manager	com.estrongs.android.pop
Link2SD	com.buak.Link2SD
SMS Popup	net.everythingandroid.smspopup
GPS Test	com.chartcross.gpstest
Gmail Unread Count OLD	se.alexanderblom.gmailunreadcount
Gun Club 2	com.nextgenreality.gunclub
Battery	com.macropinch.pearl
GO Weather	com.mediawoz.goweather
Words With Friends Free	com.zynga.words
Metal Detector	kr.sira.metal
Yandex.Weather	ru.yandex.weatherplugin
Messenger Play!	com.play.wlm
NOOK for Android by B&N	bn.ereader
T-Mobile Video Chat by Qik	com.qiktmobile.android
Puzzle Family	com.com2us.puzzlefamily.up.freefull.google.global.android.common
Battery Widget	personal.jhjeong.app.batterylite
¨ª??¨º??¨º¦Ì?¨¬??¨º?¡ã¨¬?? ?a¡§???¨¬??¨¬?? - ¨º¦Ì-¨¬?¡ä¨¬??¨¬?? ¨¬??¨¬?¡ä¨¬??¨¬??,¨¬??¨¬?¡ä¨¬??¨¬?? ??¡À	com.nozisim.checkkorean
IP Cam Viewer Lite	com.rcreations.ipcamviewer
dodol Phone (data, call, SMS u	demo.galmoori.datausage
Current Caller ID	com.webascender.callerid
iHeartRadio	com.clearchannel.iheartradio.controller
Music Download Paradise	com.androidfreak.entertainment.musicparadise
Tap Ranch	com.gameviewstudios.tapranch
HeavenHell	com.nelphy.android.heavenhell
Media Remote for Android	com.sony.seconddisplay.view
Hearts Free	uk.co.aifactory.heartsfree
Running Fred	com.dedalord.runningfred
Air Control Lite	dk.logisoft.aircontrol
Jewels Miner!	com.ezjoynetwork.jewelsminer
Hangman Free	com.optimesoftware.hangman.free
Hanging With Friends	com.zynga.hanging
NEED FOR SPEEDa?¡é Shift	com.eamobile.nfsshift_na_wf
Angry Birds Rio	com.rovio.angrybirdsrio
NBC News	com.zumobi.msnbc
Wells Fargo Mobile	com.wf.wellsfargomobile
My Pregnancy Today	com.babycenter.pregnancytracker
Noom CardioTrainer	com.wsl.CardioTrainer
Vampires Livea?¡é	com.storm8.vampires12
?¡¥?¨¦??a?a¨¦?¡¤?????????????????a???	jp.co.ignis.battery.dapan
¨¬?¡ä?¡¥?¨¬¡ì?¨ª?¡§??????	net.badpixel.android.imageparody
girl's¨¦??????-?¨¨?????5000	kao.moji
BaiduInput	com.baidu.input
NDrive 10	com.ndrive.android
Starlight Live Wallpaper Free	com.driftwood.wallpaper.starlight.free
?a¡§?¡ã?¨¬?? T world	Com.sktelecom.minit
¨¬??¨ª?¡ã?a¡§¨¬?? - ¨¬??¨¬??¨¬?¡è?¡§?¨¬?¡è ?a¡§¨¬?? 1¨¬??, ¨¬??¨¬??¨¬?? ¨¬??¨ª?¡ã?a¡§¨¬??	com.thinkreals.couponmoa
Baseball Superstars?? 2012	com.gamevil.bb2012.global
Image Pack 1 - FindDifferences	com.pineconesoft.comparatorpack1
Racing Moto	com.droidhen.game.racingmoto
Rain on the glass	com.yukka.livewallpaper.wg
BLEEP Me!	com.foncannoninc.bleep
Myxer	com.myxer.android
MobileVOIP Cheap Calls	finarea.MobileVoip
Best Funny Ringtones	com.xzFunny
SMS Ringtones Top60	com.Psms
Mushroom Garden	jp.co.beeworks.funghiGardeningKit
ilMeteo Weather	com.ilmeteo.android.ilmeteo
Talking Tom Cat 2 Free	com.outfit7.talkingtom2free
Wikitude	com.wikitude
¨º3?¨¬????????¨º¦Ì?¨ª?¦Ì¨¬???3¡ä	com.roadplus.android
DJ Studio 3	com.beatronik.djstudiodemo
Cymera	com.cyworld.camera
NATE	com.nate.android.portalmini
Animated Weather Widget, Clock	com.mobilityflow.animatedweather.free
Galaxy S3 Dandelion LWP	com.androidwasabi.livewallpaper.dandelion
Let's Golf! 3	com.gameloft.android.ANMP.GloftL3HM
Pocket -formerly Read It Later	com.ideashower.readitlater.pro
World Newspapers	com.world.newspapers
NewsHunt	com.eterno
Feedly - Google Reader | RSS	com.devhd.feedly
?¡ã¡ã???¨ª?¦Ì ¨¬??¨¬|?2	stonykids.baedaltong.season2
JuiceDefender beta	com.latedroid.juicedefender.beta
Solitaire	com.softick.android.solitaire.klondike
The Best Life Quotes	com.socialping.lifequotes
ESPN ScoreCenter	com.espn.score_center
Mxit	com.mxit.android
GO Locker	com.jiubang.goscreenlock
GO Power Master	com.gau.go.launcherex.gowidget.gopowermaster
XFINITY TV	com.xfinity.tv
DIRECTV Remote FREE!	com.WiredDFW.DIRECTV.unWiredRemoteLite
SMS Backup & Restore	com.riteshsahu.SMSBackupRestore
Wapedia: wikis & encyclopedias	com.taptu.wapedia.android
PhotoFunia	com.photofunia.android
360?????o????¡ê?	com.qihoo360.mobilesafe
Foursquare	com.joelapenna.foursquared
How to Draw - Easy Lessons	com.artelplus.howtodraw
NQ Security Multi-language	com.nqmobile.antivirus20.multilang
??¡ã¨¦?¦Ì¨¦??¨¦?¦Ì??????¨¨?¡§	idv.nightgospel.TWRailScheduleLookUp
ElectroDroid	it.android.demi.elettronica
Snake	com.example.android.snake
Basketball Throw!	com.workpail.basketballthrow
TouchDown for Smartphones	com.nitrodesk.droid20.nitroid
chompSMS	com.p1.chompsms
HeyWire - FREE Texting	com.mediafriends.chime
eBuddy Messenger	com.ebuddy.android
MultiPicture Live Wallpaper	org.tamanegi.wallpaper.multipicture
Camera360 Ultimate	vStudio.Android.Camera360
Firefox Beta	org.mozilla.firefox_beta
ChatON	com.sec.chaton
Bible Quotes	com.dodsoneng.biblequotes
Period Calendar / Tracker	com.popularapp.periodcalendar
TalkBack	com.google.android.marvin.talkback
Perfect App Protector - FREE	com.morrison.applocklite
PocketBand Lite	net.uloops.android
Photaf Panorama (Free)	obg1.Photaf
Zombie, Run!	net.peterd.zombierun
Run Like Hell!	com.masscreation.rlh
StumbleUpon	com.stumbleupon.android.app
Boat Browser Mini	com.boatgo.browser
Battery Widget	com.elvison.batterywidget
DroidStats	nitro.phonestats
Horoscope Plus	horoscope.plus
Free Advanced Task Manager	com.arron.taskManagerFree
Watchdog Task Manager Lite	com.zomut.watchdoglite
Google Currents	com.google.android.apps.currents
Smart Lock Free (App/Media)	ukzzang.android.app.protectorlite
IP Webcam	com.pas.webcam
Pudding Camera	com.kth.PuddingCamera
2D?D?D? - DoD¡ã?????? D? ??D???D¡ãD2D???D?D?DoD?	ru.dublgis.dgismobile
Match.com a?? #1 Dating Site	com.match.android.matchmobile
TasKiller free	com.tni.TasKiller
OvuView - Period Tracker	com.sleekbit.ovuview
Lomo Camera	com.onemanwithcameralomo
Extreme Droid Jump	com.electricsheep.edj
Floating Image	dk.nindroid.rss
NetCounter	net.jaqpot.netcounter
Bubble level	net.androgames.level
F18 Carrier Landing Lite	it.rortos.f18carrierlandinglite
Tank Hero	com.clapfootgames.tankhero
Fruit Ninja	com.halfbrick.fruitninja
2 Player Reactor	coolcherrytrees.games.reactor
Robo Defense	com.magicwach.rdefense
Shoot The Zombirds	pl.idreams.ShootTheZombirds
Air Attack (Ad)	dk.logisoft.airattack
Atomic Bomber	org.lukeallen.bomber
Missile Defense	com.magmamobile.game.MissileDefense
N.O.V.A. 3 - Near Orbit...	com.gameloft.android.ANMP.GloftN3HM
Assistant	com.speaktoit.assistant
Minecraft - Pocket Ed. Demo	com.mojang.minecraftpe.demo
imo messenger	com.imo.android.imoim
My Prayer - ?¦Ì¨´??¡ì?a¨´?	com.haz.prayer
My Railway	com.gameinsight.myrailway
Rings Extended	com.angryredplanet.android.rings_extended
Sexy CuteGirl Gallery	com.jjfitue.free1
Angry Birds Space	com.rovio.angrybirdsspace.ads
Amazing Alex Free	com.rovio.amazingalex.trial
Tic Tac Toe Free	com.optimesoftware.tictactoe.free
Bad Piggies	com.rovio.BadPiggies
Naked Scanner Free	atticlab.bodyscanner
Jewels Link!	com.ezjoynetwork.jewelslink
Bouncy Mouse Free	com.munkadoo.bouncymouse
Sudoku Fun	com.coolmango.sudokufun
Finger Bowling	cn.bluesky.fingerbowling
DragonVillage	com.highbrow.game
Guns'n'Glory FREE	com.hg.gunsandgloryfree
Falling Fred	com.dedalord.fallingfred
Townsmen 6 FREE	com.hg.townsmen6free
Clouds & Sheep	com.hg.cloudsandsheepfree
Aporkalypse FREE	com.hg.aporkalypsefree
Farm Invasion USA	com.hg.farminvasionfree
Guns'n'Glory WW2	com.hg.gunsandglory2free
Super Dynamite Fishing	com.hg.dynamitefishingfree
Happy Vikings FREE	com.hg.vikingfree
Hambo	com.miniclip.hambo
Monkey Kick Off -FREE fun game	com.holland9.miniclip
Fragger	com.miniclip.fraggerfree
iStunt 2	com.miniclip.istunt2
Ping Pong - Best FREE game	com.miniclip.pingpong
Gravity Guy FREE	com.miniclip.gravityguy
Mini Pets	com.miniclip.animalshelter
Extreme Skater	com.miniclip.extremeskater
The Dark Knight Rises	com.gameloft.android.ANMP.GloftKRHM
Cheese Tower	com.doodle.cheesetower
?¡é¡§¨¨?1?¡è??¡ã?	com.moji.mjweather
Letters from Nowhere 2	com.g5e.letters2
Stand O'Food??	com.g5e.standofood
Virtual City	com.g5e.virtualcity
Virtual City Playground	com.g5e.virtualcitysb
Supermarket Mania??	com.g5e.smm
Robinson	com.pixonic.robinson
Burn the Rope	com.bbb.btr
Avatar Fight - MMORPG game	com.jiuzhangtech.arena
Ninja Chicken Ooga Booga	mominis.Generic_Android.Ninja_Chicken_Ooga_Booga
Bouncy Bill	mominis.Generic_Android.Bouncy_Bill
Hoopz Basketball	mominis.Generic_Android.Hoopz
PlayScape	playscape.mominis.gameconsole.com
Asphalt 7: Heat	com.gameloft.android.ANMP.GloftA7HM
UNOa?¡é FREE	com.gameloft.android.ANMP.GloftUFHM
Defender	com.droidhen.defender
Amazing Tattoo Ideas FREE	com.fishdroid.amazing.tattoos
Stickman Base Jumper (Free)	com.djinnworks.StickmanBaseJumper.lite
Raging Thunder 2 - FREE	com.polarbit.rthunder2lite
Raging Thunder - FREE	com.polarbit.rthunderlite
Reckless Racing Lite	com.polarbit.RecklessRacingLite
Wave Blazer - FREE	com.polarbit.waveblazerlite
MX Player Codec (ARMv6)	com.mxtech.ffmpeg.v6
MX Player	com.mxtech.videoplayer.ad
MX Player Codec (ARMv6 VFP)	com.mxtech.ffmpeg.v6_vfp
MX Player Codec (ARMv7)	com.mxtech.ffmpeg.v7_vfpv3d16
Sea Stars	com.hotheadgames.android.seastars
Big Win Baseball	com.hotheadgames.google.free.bigwinbaseball
Big Win Soccer	com.hotheadgames.google.free.bigwinsoccer
Big Win Football	com.hotheadgames.google.free.bigwinfootball
Treasures of Mystery Island	com.alawar.mysteryisland
Photo Collage	com.fotolr.photoshake
ZenDice free	dk.endgame.SuperYatzy
PapiRiver	net.sunflat.android.papiriver
Streamzoo	com.phonezoo.android.streamzoo
¨¬?¡è???¨¬?? OVJET	com.kiwiple.ovjet
Word Search	com.abhipedro.wordsearch.view
Zoo Story	com.teamlava.zoostory
Jewels Maniac!	com.ezjoynetwork.jewelsmaniac
Texas Holdem Poker Pro	com.geaxgame.pokerkingpro
VIP Poker	com.tinyco.poker
Angry Gran Run - Running Game	com.aceviral.angrygranrun
Top Girl	com.crowdstar.topgirl
Doodle Devila?¡é F2P	com.joybits.doodledevil
Doodle Goda?¡é F2P	com.joybits.doodlegod_f2p
X-Runner	com.droidhen.game.xrunner
Turbo Kids	com.droidhen.turbo
Defender II	com.droidhen.defender2
Dinosaur War	com.droidhen.game.dinosaur
Coin Machine	com.droidhen.game.coin
Bubble Blast Holiday	com.magmamobile.game.BubbleBlastHoliday
Cordy	com.silvertree.cordy
PAC-CHOMP! namco	com.namcobandaigames.pacchomp
PAC-MAN Championship Ed. Demo	namco.pacman.cedemo
Marmiton	com.aufeminin.marmiton.activities
Se Coucher Moins B?ate	com.secouchermoinsbete
Angry Gran Best Free Game	com.aceviral.angrygran
Zombie Dash	com.a1.game.vszombies
Slots Heaven:FREE Slot Machine	com.twelvegigs.heaven.slots
WeatherBug	com.aws.android
McAfee WaveSecure (Trial)	com.wsandroid
Dog Whistle Free	proffesionals.dog.whistle.cat.repelent
Swiped	com.igoldtech.an.swiped
Jewels Pro	com.play.Jewels3
Cestos Full	com.chickenbrickstudios.cestos_full
Jewels Deluxe	com.RunnerGames.game.JewelsDeluxe_AD
Monster Shooter	com.gamelion.MonsterShooter
SMALL STREET	com.glu.smallstreet
Tri Peaks HD	com.be.android.tripeaks
Solitaire Deluxe??	com.gosub60.solfree2
Solitaire Free Pack	com.tesseractmobile.solitairefreepack
FreeCell Solitaire	com.mobilityware.freecell
Line Runner (Free)	com.djinnworks.linerunnerfree
GlowPuzzle	com.glosculptor.glowpuzzle
old offender|Escape from jail	com.izumi.old_offender
Paper Racing	com.droidhen.paperracing
Lair Defense: Dungeon	com.hz.game.ld
Cloudy	com.droidhen.game.cloudy
Sniper	com.roidgame.sniper
Sketch Me	com.roidgame.sketchmet
Tumblr	com.tumblr
Mini Golf'Oid Free	net.pierrox.mini_golfoid_free
CGV	com.cgv.android.movieapp
Flood-It!	com.labpixies.flood
Bubble Shoot	com.droidhen.game.bubblemaniac
Pool Mania	com.game.PoolMania
Yoo Ninja Plus	com.RunnerGames.game.YooNinja_Plus
Ceramic Destroyer	com.game.CeramicDestroyer
BMX Boy	com.game.BMX_Boy
Basketball Shoot	com.game.basketballshoot
Tiny Robots	com.RunnerGames.game.TinyRobots_New
Tiny Robots Beta	com.RunnerGames.game.TinyRobots
Golf 3D	com.wordsmobile.golf
Army Sniper	com.sniper.activity
Diamond Blast	com.brave.diamond
Cartoon Wars	com.gamevil.cartoonwars.one.global
Punch Hero	com.gamevil.punchhero.glo
Baseball Superstars?? Free	com.gamevil.bs09lite
Cartoon Wars: Gunner+	com.gamevil.cartoonwars.gunner.global
Cartoon Wars 2	com.gamevil.cartoonwars.two.global
DESTINIA	game.destiniaeng
Baseball Superstars?? II	com.gamevil.bs2.global
ZENONIA?? 4	com.gamevil.zenonia4.global
101-in-1 Games	com.nordcurrent.Games101
Labyrinth Lite	se.illusionlabs.labyrinth.lite
Homerun Battle 3D	com.com2us.HB3D
Ideal Weight (BMI)	mmapps.bmi.calculator
Wind-up Knight	com.robotinvader.knightmare
Angry Monkey	com.tgb.kingkong
Zoo Club	com.chromaclub.zooclub
Meteor - CHMI meteoradar	org.androworks.meteor
Winds of Steel Demo	com.deckeleven.windsofsteeldemo
Robo Defense FREE	com.magicwach.rdefense_free
Tank Hero: Laser Wars	com.clapfootgames.laserwarsfree
BIG TIME GANGSTA	com.glu.android.brawler
QQ??o¨¦?¡ä	com.qzone
Stupid Zombies	com.gameresort.stupidzombies
Jetpack Joyride	com.halfbrick.jetpackjoyride
World Wara?¡é	com.storm8.worldwar
World Wara?¡é - 14 Honor Points	com.storm8.worldwar14
Ninjas Livea?¡é	com.storm8.ninjas12
Racing Livea?¡é - 12 Points	com.storm8.racing12
Pets LIVEa?¡é	com.storm8.pets12
Kingdoms Livea?¡é	com.storm8.kingdoms12
SpeedBoat Shooting	com.aceviral.speedboat
Mafia Game - Mafia Shootout	com.aceviral.mafiashootout
Angry Gran 2	com.aceviral.ag2
Warzone Getaway Counter Strike	com.aceviral.warzonegetaway
Big Business	com.gameinsight.bigbusiness
Guns	com.calfordcn.gu
Garfield's Defense	com.webprancer.google.garfieldDefense
INDESTRUCTIBLE	com.glu.indestructible
Boyaa Fight Landlord	com.boyaa.lordland.fb
Walgreens	com.usablenet.mobile.walgreen
PewPew	com.jyaif.pewpew
Burger	com.magmamobile.game.Burger
Drag Toilet Paper	com.reverie.game.toiletpaper
Call Recorder	polis.app.callrecorder
Air Hockey Deluxe	com.play.airhockey
Exchange Rates	net.xelnaga.exchanger
Mint.com Personal Finance	com.mint
Bus Parking 3D	com.gameshell.busparking3d
DEER HUNTER CHALLENGE	com.glu.android.deerchal
Battle Ludo	com.sohomob.android.aeroplane_chess_battle_ludo_2
Moco - Chat, Meet, Games	com.jnj.mocospace.android
DATING (meet singles)	fr.LevelMatchCity
SuperGNES Lite (SNES Emulator)	com.bubblezapgames.supergnes_lite
aTilt 3D Labyrinth Free	com.fridgecat.android.atiltlite
Armored Strike Online (Lite)	com.requiem.armoredStrikeLite
Armored Strike Online	com.requiem.armoredStrike
Basketball Shot	com.droidhen.basketball
iRunner	com.droidhen.irunner
Donkey Jump	com.droidhen.game.donkeyjump
Car Conductor: Traffic Control	com.droidhen.car3d
CJ: Strike Back	com.droidhen.game.cityjump
Trial Xtreme 2 Winter	com.galapagossoft.trialx2_winter
Trial Xtreme Free	com.galapagossoft.trialdemo
BathingCat	jp.sugitom.android.furoneko
ThrottleCopter	com.throttlecopter
Tangram	com.magmamobile.game.Tangram
Devil Ninja2 (Mission)	com.droidstudio.game.devil2mis
Devil Ninja	com.droidstudio.game.devilninja
The World of Magic	com.com2us.imo.normal.freefull.google.global.android.common
Radiant Defense	net.hexage.defense
Super Scratch Offs Lotto Game	com.superluckycasino.scratchers
MOTOR TREND News	com.zumobi.android.motortrend
Princess Punt	jp.gungho.kerihimequest
MP3 Quran	appinventor.ai_hamada_yousef_o.MP3Quruan_2
UEFA Champions League edition	com.afl.seucom.view
Hindi Songs & Bollywood Music	com.dhingana.free.app
Horoscope and Tarot	app.horoscope1_5.com
Couple Vow	com.ms.coupleobserver
Easy Downloader Pro	com.et.easy.download.pro
Easy Video Player	com.easy.video.player
Watch TV Free	com.livetv.watch.tv
Talking Puppy	com.lily.times.dog1.all
T??l??7 programme TV	com.ldf.tele7.view
Poop Rearing Simulator Mobile	jp.android.unko
TV SPIELFILM	de.tvspielfilm
GPS Status & Toolbox	com.eclipsim.gpsstatus2
Shopper	com.google.android.apps.shopper
TeleNav GPS Navigator for TMO	com.telenav.app.android.telenav
Urbanspoon	com.urbanspoon
Talking Ted LITE	com.nbcuni.universal.talkingted
Best Apps Market / Free Apps	com.bestappsmarket.android.bestapps
Softonic Moba	com.softonic.moba
Drum Kit	com.phellax.drum
Perfect Viewer	com.rookiestudio.perfectviewer
Viki a?? TV, Movies & Music	com.viki.android
ModFace Free	br.eddj.modf
WHERE	com.ulocate
MySettings	jqsoft.apps.mysettings
KAYAK	com.kayak.android
Mojo GBA Lite	com.momojo.gba.lite
GroupMe	com.groupme.android
JustPictures!	com.justpictures
IM+	de.shapeservices.impluslite
Fingerprint Lock Free	com.nb.fingerprint.lock.free
??¡è¨¬?? - Daum	net.daum.android.daum
??¡è¨¬?? tv¨ª?? - Daum tvPot	net.daum.android.tvpot
Google Drive	com.google.android.apps.docs
avast! Mobile Security	com.avast.android.mobilesecurity
ALYac Android	com.estsoft.alyac
InstaPicFrame for Instagram	com.tinypiece.android.ipf
WiFi Booster Easy Connect a?	com.wifiboostereasyconnect
Call of Duty?? ELITE	com.activision.elite
Starfield 3D Live Wallpaper	com.kalicinscy.wallpaper.starfield
VK Video D2D?D¡äD¦ÌD?-D¡ã??D¡äD?D? D?D?D¦ÌD¦Ì?? 2.9	com.vkvid.player
Winamp	com.nullsoft.winamp
eBuddy XMS	com.ebuddy.android.xms
Smooth Calendar	se.catharsis.android.calendar
Slots Tycoon	com.ziplinegames.slotstycoon
SpeedMoto	Game.SpeedMoto
SpeedCarII	Game.SpeedCar2
Box	com.box.android
Modern Conflict	com.gaijinent.modernconflict
Yahoo! Messenger	com.yahoo.mobile.client.android.im
Yahoo!	com.yahoo.mobile.client.android.yahoo
Yahoo! Weather	com.yahoo.mobile.client.android.weather
Yahoo! Mail	com.yahoo.mobile.client.android.mail
Police Scanner Radio Scanner	com.berobo.android.scanner
¨¦?¡¤???¨¦?3?1?2012(¨¦?3?1???-?????¡§)	cn.kuwo.player
FrostWire	com.frostwire.android
Parallel Kingdom MMO	com.silvermoon.client
Demon Hunter	com.bicore.dhunter
Pimple Popper	mobilehead.android.pp
Guess That Song - Music Quiz	quess.song.music.pop.quiz
Rope'n'Fly - From Dusk (Free)	com.djinnworks.RopeFly.lite
Pocket Bingo Free	com.apostek.apps.pocketbingo
GSN Casino	com.gsn.android.casino
i Fishing Lite	com.RockingPocketGames.iFishingLite
DatPiff Mobile	com.datpiff.mobile
Graffiti Ball	com.backflipstudios.android.graffitiball
iPhone 4S Screen	com.Hace.Iphone4SScreen
Fashion Storya?¡é	com.teamlava.fashionstory
Norton Security and AntiVirus	com.symantec.mobilesecurity
Angel Piano.	com.AngelPiano
???????????o¨¨????£¤?3?	com.sohu.inputmethod.sogou
Tattoo Tycoon FREE	com.hg.tattootycoonfree
SongPop	air.com.freshplanet.games.SongPopPremium
Santa's Village	com.makingfun.santasvillage
Race Of Champions	com.invictus.roc
My Horse	com.naturalmotion.myhorse
Memory Booster - RAM Optimizer	imoblife.memorybooster.lite
ActionPotato	net.sunflat.android.actionpotato
PapiWall	net.sunflat.android.papiwall
SFCave	net.sunflat.android.sfcave
MapleStory Live	com.nexonmobile.maplelive.googleplayexp
Replica Island	com.replica.replicaisland
Paradise Island	com.seventeenbullets.android.island
Thief Lupin!	com.abluewind.thieffree
Car Valet	com.magmamobile.game.CarValet
??¡ä¨¨¦Ì¡ã?????? ???¨¨?????¨¨??	jp.ne.donuts.tanshanotora
Gem Miner	au.com.phil.minedemo
Avenger	com.avenger
My Country	com.gameinsight.mycountry
Diamonds Blaze	com.gameinsight.diamondsblaze
Assaulter	com.supercsman
Mystery Manor	com.gameinsight.mmandroid
Rule the Kingdom	com.gameinsight.kingdom
POF Free Online Dating	com.pof.android
Bike Race Free - Top Free Game	com.topfreegames.bikeracefreeworld
X-plore File Manager	com.lonelycatgames.Xplore
MARCA.com	com.iphonedroid.marca
Smart Optimizer	com.adcall.smartoptimize
Chase Mobile	com.chase.sig.android
WiFinder	com.pgmsoft.wifinder
screenshot	com.geeksoft.screenshot
Death Racing	com.feelingtouch.racingcar
Zombie Terminator	com.feelingtouch.cocos2dzombie
Dragon Hunter	com.feelingtouch.dragon.ice
Zombie Frontier	com.feelingtouch.gunzombie
Mirror	co.sastudio.mirror
Stadium Horn Free	com.progimax.airhorn.free
Candle Free	com.progimax.candle.free
City Storya?¡é	com.teamlava.citystory
Nightclub Storya?¡é	com.teamlava.nightclubstory
Dragon Storya?¡é	com.teamlava.dragon
Pet Shop Storya?¡é	com.teamlava.petshop
Papaya Farm HD	com.papaya.papayaandroidfarm_hd
Poker Master (Poker Game)	com.incrediapp.poker.texas.holdem.calculator.iq.test
My Country: Sports Edition	com.gameinsight.mycountry.sport
Apache Attack: Heli Arcade	com.tgb.hg
Track My Train	com.tgb.bg.tmt
Gang Wars	com.geniteam.gangwars.lite
Quests & Sorcery	com.mobage.ww.a561.rpg
AREL WARSa?¡é	com.gamevil.eruelwars.global
Springpad	com.springpad
Tap Dragon Park	com.pocketgems.android.dragonpark
ZombieBooth	com.motionportrait.ZombieBooth
Backgrounds Box HD	com.adao.gano.bbhd3
LiveHome	com.mo.android.livehome
Tap Blox	com.entwicklerx.tapblox
Major Mayhem	com.turner.asmajormayhem
Duck Hunter	com.droidhen.duck2
Falling Ball	com.reverie.game.fallingball
Tap Resort Party	com.bighedgehog.tapresort.party.android
Tiny Monsters	com.tinyco.monsters
Bubble Shoot	com.likeapp.game.bubbleshooter
Stair Dismount	com.secretexit.dismount
Textgram	codeadore.textgram
""Kaomojikun15000 a??Lovely and F	jp.beyond.kaomoji
LINE???¨¦?????¨¦????2?¡èo???????????¡è??3¨¦???????????	com.apapjp.line
Auto Call Recorder	com.appstar.callrecorder
GO SMS Pro FBChat plug-in	com.jb.gosms.chat
SportsTap	mobi.sportstap.android.sportstap
Battery Booster	imoblife.batterybooster
Zoosk - friend, chat, dating	com.zoosk.zoosk
Planets n Stars Live Wallpaper	com.planetsnstarslivewallpaper.rainbowapp
Free Aquarium Live Wallpaper	com.freeaquariumlivewallpaper.nick
Path	com.path
Piano Master FREE	it.b77.pianomasterfree
me2day	com.nhn.android.me2day
??¡è¨¬?¡ä?2? ¨¬¡ì????/¨º¦Ì?¨ª?¦Ì a?? Naver Map	com.nhn.android.nmap
N??????¨¬?¡ä??? - ¨¬??¨¬¡ì? ?¡ã¡À¨¬?? - Naver Ndrive	com.nhn.android.ndrive
??¡è¨¬?¡ä?2? ¨¬1¡ä¨ª??  - Naver Cafe	com.nhn.android.navercafe
Steam	com.valvesoftware.android.steam.community
Ameba	jp.ameba
MiuMeet - Live Online Dating	com.miumeet.android.client
Football Kicks	com.distinctivegames.footballkicks
Kick it out! Football Manager	de.ludetis.android.kickitout
Racing Livea?¡é	com.storm8.racing
Color Splash FX	slide.colorSplashFX
H??a¨¨?¡À???2ch?????????????????¡§????????a??¡¥??a??????¨¦?????????????????	com.eyeputti.hnahanashi1
AgingBooth	com.piviandco.agingbooth
Beauty Camera	com.northpark.beautycamera
Parking Frenzy 2.0	com.games2win.parkingfrenzy
VZ-Netzwerke	net.studivz.android
Fake iPhone 4S	com.bb.iphone
GetGlue	com.adaptiveblue.GetGlue
Hyves	com.hyves.android.application
??¡ã??¡ê¨¦?¡ê?o????	com.cattailsw.dramaapp
MiniFetion	com.hy.minifetion
HD Film Izle	com.tasomaniac.hdfilmizle
Inotia3: Children of Carnia	com.com2us.inotia3.normal.freefull.google.global.android.common
X City	com.aidigame.xcity
Zombies...OMG!	com.loloworks.llzbs
Battery Indicator	com.fulminesoftware.batteryindicator
OkCupid Dating	com.okcupid.okcupid
Bank of America	com.infonow.bofa
Shake - Screen Off	com.droiddev.shake
Skout - Meet, Chat, Friend	com.skout.android
Internet radio	com.maxxt.pcradio
R??sultats Foot en Direct	com.activaweb.matchendirect
Cyworld	com.btb.minihompy
Hi There	com.psynet
¨ª?¡À¨ª?? - TicToc	kr.co.tictocplus
Random chat for Korean	net.devking.randomchat.android
Dominoes!	com.bytesequencing.android.dominoes.free
Scary Ringtones	com.aura.ringtones.aurascaryringtones
Cribbage Pro	com.fullersystems.cribbage
Bubble Popper	com.bytesequencing.bubble_popper_ads
Spades!	com.bytesequencing.spades_ads
Anti Theft Alarm	mmapps.mobile.anti.theft.alarm
Calls Blacklist	com.vladlee.easyblacklist
???????¡ì??¡ì?	com.mt.mtxx.mtxx
Bingo Bash	air.com.bitrhymes.bingo
Unblock Car	com.ruanshaomin.game
SimSimi	com.ismaker.android.simsimi
Basketball Mania	com.virgil.basketball
Phase 10	com.magmic.phase10
Live Holdem Poker Pro	com.dragonplay.liveholdempro
OpenSudoku	cz.romario.opensudoku
zilch free (dice game)	com.mibollma.zilchR2
Beer Pong HD	com.codeglue.BeerPong
Sonic CD Lite	com.soa.sega.soniccdlite
Stick Swing	com.hz.game.stickswing
Drift Mania Championship Lite	com.ratrodstudio.driftmanialite
The Oregon Trail: Settler	com.gameloft.android.ANMP.GloftTOHM
Find Differences	com.pineconesoft.comparator
¨¦o??¡ã? ??????3??o1 -16??¦Ì	com.igs.mjstar31
Building Tower	com.amusetime.buildingtower
Touch Pool 2D Lite	com.selticeapps.poollite
Leo's RC Simulator	leofs.android.free
Kik Messenger	kik.android
jjanglive	com.uajjang.android
Talking James Squirrel	com.kauf.talking.baum.TalkingJamesSquirrel
Talking John Dog & Soundboard	com.kauf.talking.baum.TalkingJohnDogandSoundboard
Fart Sound Board	com.kauf.soundboard.baum.FartSoundBoard
Alchemy	me.zed_0xff.android.alchemy
Hill Climb Racing	com.fingersoft.hillclimb
Coin Pirates	com.nubee.coinpirates
Pulse News	com.alphonso.pulse
News Republic	com.mobilesrepublic.appy
Octopus	com.magmamobile.game.Octopus
Strip Poker - Eva Angelina	net.aaronsoft.poker.eva
Sexy Strip Poker - Schoolgirls	net.aaronsoft.poker.school1
Strip Holdem - Alexis Texas	net.aaronsoft.holdem.alexis
Strip Blackjack 21 - Lisa Ann	net.aaronsoft.blackjack.lisaann
Slot Machine - Jesse Jane	net.aaronsoft.slotmachine.jesse
Strip Blackjack - Sandee West	net.aaronsoft.blackjack.sandee
Strip Poker - Fan Edition #3	net.aaronsoft.poker.fan31
White Noise Lite	com.tmsoft.whitenoise.lite
MMA NewsArena	com.teamandroid.mmanews
DoubleDown Casino - Slots	com.ddi
Coin Dozer	com.leftover.CoinDozer
Horse Frenzy	com.gamecircus.HorseFrenzy
Cookie Dozer	com.leftover.CookieDozer
Prize Claw	com.gamecircus.PrizeClaw
Deluxe Cafe	com.namcobandaigames.deluxecafe
Trap!	com.mattwach.trap2
First Aid	com.usa.health.ifitness.firstaid
Beautiful quote	com.over.quote.newver
Anecdotes.	com.over.joke
Weather for Switzerland	com.idmobile.swissmeteo
Weather for France	com.idmobile.francemeteo
Love Horoscopes	com.dailylovehoroscopes.net
Unicorn Dash	com.game.UnicornDash_Plus
Rage Reader	com.zolgatron.app.ragereader
Garfield's Diner Hawaii	com.webprancer.google.GarfieldsDinerHawii
Empire Defense II	gts.td2.am.full
Mission Of Crisis	gts.mombierush.full.en.all.google
Kingdom Royale	com.gamevil.projectn.global
Penguin I - Classic	com.hz.game.penguin
Medieval Castle Defense	com.nova.root
Lighter Free	com.progimax.lighter.free
Pick a Stick	de.bigbyte.games.pickastick
Abduction!	au.com.phil
Pretty Pet Salon	com.animoca.prettyPetSalon
Bridge the Wall	com.innovativeGames.bridgeTheWall
Nyan Cat: Lost In Space	com.istomgames.engine
The Schwartz Unsheathed	com.android.app.schwarz
AK-47	com.scheffsblend.ak47
SchottGunn	com.scheffsblend.schottgunn
Freekick Battle	com.gamevil.freekickbattle.glo
MyCalendar Free	com.kfactormedia.mycalendarmobile
Life is Crime	com.redrobotlabs.lifeiscrime
Striker Soccer	com.strikermanager.android.strikersoccer
Talking Translator /Dictionary	com.greenleaf.android.translator.enes.a
How to Tie a Scarf	com.artelplus.howtoscarf
Shakes & Fidget - The Game App	com.playagames.shakesfidget
Electric Touch	com.yukka.livewallpaper.electric
Millionaire Slots	com.fruityfun.millionaireslots
body symbol	vn.esse.bodysymbol
Fake iPhone 5	com.mdb.android.fakeiphone5
Super Sudoku	com.kiwifruitmobile.sudoku
Funny Love Test	com.gameinsight.funnylovetest
WiFi Finder	com.jiwire.android.finder
Trapster	com.trapster.android
Brasileir?¡êo	br.com.zynger.brasileirao2012
Video Live Wallpaper	com.ccpcreations.android.VLW
MP3 Cutter	com.beka.tools.mp3cutter
Hide It Pro	com.smartanuj.hideitpro
20000 Awesome Jokes	com.smartanuj.jokes
Talking Blonde Assistant 3D	com.ifree.massistant
PayPal	com.paypal.android.p2pmobile
USAA Mobile	com.usaa.mobile.android.usaa
Frozen Bubble	org.jfedor.frozenbubble
Menstrual Calendar	com.guillaumegranger.mc
Square Register	com.squareup
MightyText - SMS from Computer	com.texty.sms
Crunchyroll - Anime and Drama	com.crunchyroll.crunchyroid
Wifi Unlocker 2.0	com.anontechs.wifiunlock
Traffic Panic London	com.neonplay.trafficpanic4
Androidify	com.google.android.apps.androidify
?¡ã¡ã???¨¬???¡¥?¨¬?¡À	com.sampleapp
Azan Prayer Time Pro	com.MindTrack.prayerPro
Swiss Weather Radar	com.tju.android.radar
Steamy Window	com.appspot.swisscodemonkeys.steam
Funny Jokes	com.appspot.swisscodemonkeys.jokes
Color Touch Effects	com.appspot.swisscodemonkeys.paintfx
Ezan Vakti / Namaz Saati Pro	com.mobilexsoft.ezanvakti
Maze!	fr.opena.maze
Pageonce - Money & Bills	com.netgate
RadarNow!	com.usnaviguide.radar_now
Brightest LED Flashlight	com.surpax.ledflashlight.panel
Pool Master Pro	com.forthblue.pool
Truth or Dare	com.mangoes.truthordare
Namazu Alert	jp.twiple.android.quake
Legendary Heroes	im.maya.legendaryheroes
BLOOD & GLORY (NR)	com.glu.gladiator_nr
Scrambled Net	org.hermit.netscramble
Sky Map	com.google.android.stardroid
¨¬??¨ª???|?¨¬1¡äTV - afreecaTV	kr.co.nowcom.mobile.afreeca
CUKI Launcher	com.skt.sptagentgl
Real Drum	br.com.rodrigokolb.realdrum
Radar	com.google.android.radar
Most popular Ringtone	com.xzPopular
PPTV????????¦Ì¨¨¡ì?(?????o???)	com.pplive.androidphone
Virtual Table Tennis 3D	com.clapfootgames.vtt3dfree
Wheres My Droid	com.alienmanfc6.wheresmyandroid
TripIt Travel Organizer Free	com.tripit
Booking.com - 240,000+ hotels	com.booking
My Cars	com.aguirre.android.mycar.activity
Backgrounds	com.ogqcorp.bgh
One Browser -formerly iBrowser	com.tencent.ibibo.mtt
Triple Stack HD (Pyramids)	com.be.android.tritower
DB Navigator	de.hafas.android.db
D?D?D?D?D?D?D???Do	ru.kinopoisk
Okey	com.ahoygames.okey
Traktor Digger	com.kuriusgames.traktordigger
A Online Radio	com.leadapps.android.radio
Bird Blast	com.ezjoynetwork.birdblast
Classic Simon	com.neilneil.android.games.simonclassic
Ski Safari	com.DefiantDev.SkiSafari
graBLOX Puzzle Game	com.voldaran.puzzle.graBLOX
No Lock	org.jraf.android.nolock
Parallel Mafia MMORPG	com.perblue.pm.client
Rock The Vegas	com.seventeenbullets.android.vegas
Trial Xtreme 2 Free	com.galapagossoft.trialx2_gl2_demo
Bistro Cook	quasar.bistrocook
Slots Royale - Slot Machines	com.mw.slotsroyale
Finger Slayer	com.rvappstudios.fingerslayer
¨¦?1¨¦????1??¡è?¦Ì? Assaulter	com.assaultertw
Truco Free	com.blyts.trucolite.activities
Parkour: Roof Riders Lite	com.blyts.parkourlite.activities
??o?????????SNS??¡¥?????????????????????????????????	jp.co.ibec.HappyMail
Texas HoldEm Poker Deluxe	com.igg.pokerdeluxe
Slotomania - slot machines	air.com.playtika.slotomania
Big Win Slotsa?¡é	com.gosub60.BigWinSlots
My Clinic	com.gameinsight.myclinic
Fantasy Town	com.gameloft.android.ANMP.GloftFVHM
Dominoes	com.cdroid.dominoes
Smurfs' Village	com.capcom.smurfsandroid
Light Racer	net.rbgrn.lightracer
Tiki Kart 3D	com.arbstudios.tikikartfree
Plague Inc.	com.miniclip.plagueinc
Math Maniac	de.math.maniac
UC Browser - Smart Web Browser	com.UCMobile.intl
Antivirus & Mobile Security	com.trustgo.mobile.security
TrustGo Antivirus	com.trustgo.security
Shane Reaction: Zombie Dash	com.artbit.shanereactionfree
Hamster Life	com.crossfield.namsterlife
Mahjong: Godgame Mahjong	com.godgame.mj.android
¨¬o????¨ª?? for Kakao	com.linktomorrow.candypang
11st	com.elevenst
Funny Status for Facebook LITE	com.venikom.facebook.lite
Cricbuzz Cricket Scores & News	com.cricbuzz.android
zaycev.net	free.zaycev.net
TV Thailand	com.iamm.android.tvthai
ArabicFonts ( No Root ) ???¡¤¨´??¡¤	com.ksa.arabicfonts
Booooly2 for Kakao	com.nextapps.BoooolyOnline.android.kakao
Pose	com.pose
Between - app for couples	kr.co.vcnc.android.couple
Forces of War	com.uken.android.forcesofwar
Locus Free	menion.android.locus
NH ¨¬?¡è?¡ì?¨ª???¡À?¨ª?1	nh.smart
Lord of Magic	com.animoca.google.lordofmagic
TED	com.ted.android
Heart Live Wallpaper	com.livewallpaper.livewallpaper.jjhearts
Thumb	com.opinionaided
Appy Geek	com.mobilesrepublic.appygeek
Baby Adopter??	com.x2line.android.babyadopter.lite
textPlus Free Text + Calls	com.gogii.textplus
Songify	com.smule.songify
Magic Piano	com.smule.magicpiano
Flikie Wallpapers HD	com.flikie.wallpapers.hd
Bouncy Ball	com.raongames.bouneball
La chaine m??t??o	com.lachainemeteo.androidapp
Mr. Number-Block calls, texts	com.mrnumber.blocker
???????????????¨¦?????	com.sanguomobile.paypal
MyCalendar Beta	com.kfactormedia.mycalendar
Pyramid Rising	com.bloobuzz.pyramidrising
100 Floors Official Cheats	com.tobiapps.android_100floors_guide
[WordHero]	com.rhs.wordhero
AutoRap	com.smule.autorap
Friends, Fun, Free a?? qeep	com.bluelionmobile.qeep.client.android
Best Wallpapers HD	com.wallpapers.backgroud.hd
DragonFlight for Kakao	com.NextFloor.DragonFlightKakao
¨¬??¨¬?¡ä??????¨¬?¡è¨ª?? for Kakao	com.patistudio.milc4kakao
Ghost Sniper : Zombie	appplus.jun.sniper.googleplay
War of Reproduction	org.appplus.tadpolewarGoogle
ScoreNinja	com.scoreninja
Sushi Bar	com.roidgame.sushichain.activity
Football Club Logo Quiz	com.fesdroid.fblogoquiz
Logo Quiz Fun Plus	com.fesdroid.logoquiz
Logic Master	com.kangaroo.logic
¨º¡ã????¨¬????? ??¡À?¡ì??¡ì?¨¬??¨º?¡ã2013	com.abluewind.gso
Muslim Pro: Azan, Quran, Qibla	com.bitsmedia.android.muslimpro
aFlashlight - flashlight LED	nu.mine.tmyymmt.aflashlight
Garfield's Diner	com.webprancer.google.GarfieldsDiner
?2¡§365a?a ??¡ä?¡ê? ?2¡§¨¬???|?,¨¬??????¡ì?,???¨¬??¨¬??,MP3,¨¬1¡ä¨¬1¡ä¨¬?¡è¨ª??	com.munets.android.bell365hybrid
Make Me Bald	com.appspot.swisscodemonkeys.bald
Sky Gamblers: Rise of Glory	com.namcobandaigames.riseofglory
Songza	com.ad60.songza
iFunny :)	mobi.ifunny
Mystique Ch1: Foetus	com.bendroid.mystique1
Modern War	jp.gree.modernwar
Hello Kitty Cafe	com.sd.google.helloKittyCafe
LOVOO	net.lovoo.android
Crack Your Screen	mk.g6.crackyourscreen
Townsmen	com.hg.townsmen7free
Amateur Surgeon: Heart Surgery	com.addictivegamesinc.amateur.surgeon
Gym Babes	com.vertex.gymbabes
MW3 Guns	gpr.apps.mw3guns
CS Guns	gpr.apps.counterstrikeguns
Puzzles with Matches	com.celticspear.matches
wetter.com	com.wetter.androidclient
Photo Studio	com.kvadgroup.photostudio
Ringtone Heaven	com.bell.brain0
Easy Photo Merge Free	kr.co.smartstudy.enaphotomerge_free_googlemarket
Bubble Pop	sp.app.bubblePop
100 Floors	com.tobiapps.android_100fl
Ocean Tower	com.flaregames.oceantower
GG	pl.gadugadu
Zombie Caf??	com.capcom.zombiecafeandroid
Monster Pet Shop	com.capcom.monsterpetshop
Luckiest Wheel (Free)	com.marzoa.ruletafree
Logo Quiz	de.androidcrowd.logoquiz
Destiny Defense:Angel or Devil	com.morisoft.AndroidFreeGamENG.AOD
Carnivores: Dinosaur Hunter HD	com.tatem.dinhunterhd
Stickman Cliff Diving (Free)	com.djinnworks.StickCliffDiving.lite
Talking Cat	com.lily.times.cat1.all
The WiFi Hacker	com.gsoftteam.thewifihacker
Speed Night	com.icloudzone.SpeedNight
Free TV	com.smart.tvgratis
Stylish Sprint	SSGlobal.pack
Logo Quiz	net.jroen.LogoQuiz
OceanCraft	com.upon.piratecove
100 Doors	com.mpisoft.doors
war of reproduction Ex	org.appplus.tadpolewarGoogleEx
Slot City - Slots Machines	com.dragonplay.slotcity
Farm Casino - Slots Machines	com.dragonplay.farmcasino
BeNaughty - Flirty Dating	com.benaughty
Skyrock	mobi.skyrock.SkyrockFM
Virtual Guitar Ultimate	awesome.virtual.guitar.tiny
¨¬??¨ª?¦Ì?¡ì?¨º3? 2012	com.gamevil.jt2012.global
??1¨¦?????¨¨?3???¨¨¡ì¡ê???????????????SD??????????¡ì????+??-??¡ê?????¡¤??£¤???¨¦?¡è	jp.co.ignis.memory.dapan
QuickPic	com.alensw.PicFolder
?2¡§¨ª??-??¡ä?¡ê? ?2¡§¨¬???|?,¨¬??????¡ì?,¨¬???|?¨¬??,¨¬1¡ä¨¬1¡ä¨¬?¡è¨ª??,¨¬?????¨ª??,¨¬o????¨ª??	wiz.bellpang.com
¨¬??¨¬????¡ä¨ª????¡è¨¬?¡ä+?2¡§¨¬???|?-?????¡è¨¬¡ì?	kr.danal.DAL
aCar - Track your vehicles	com.zonewalker.acar
GRAVITY PROJECT	com.Alper.GravityProject
Battle.net Authenticator	com.blizzard.bma
Mushroom Garden Seasons	jp.co.beeworks.funghiGardeningKitSeasons
Mushroom Garden Deluxe	jp.co.beeworks.mushroomDX
¨¨¡ì??????¦Ì??¡é???¨¨??¨¨???????1????????¡è	jp.co.beeworks.funghiGardeningKitKoZh
9GAG (free)	org.faked.gag9
Mensagens para Celular	com.gdacarv.app.mensagensparacelular
Touch	com.enflick.android.ping
Retired Wizard Story	com.westriversw.RWS
Cat War	com.westriversw.CatWar
Slime vs. Mushroom2	com.westriversw.SvsM2
Live Chat	com.appspot.swisscodemonkeys.livechat
100,000 Free Books Wattpad	wp.wattpad
Better Cracked Screen	com.m3roving.bettercrackedscreen
Taiwan weather information	com.kny.TaiwanWeatherInformation
?¡è¡ì?¡¥?¨¨¡ÀaBEST	jp.willent.Daifugo3min
TeamViewer for Remote Control	com.teamviewer.teamviewer.market.mobile
Banjo	com.banjo.android
Penalty ShootOut football game	com.box10.penaltyshootout
My Data Manager	com.mobidia.android.mdm
Battle Racing 3D Car Games	com.ggee.vividruntime.gg_913
ENCHANT U	com.glu.enchantu
imo messenger beta	com.imo.android.imoimbeta
Fingerprint Lock	com.mhedia.fingerprintlock
¨ª?¡ã¨¬1??¡¥1¨¬?¡è2	com.gamevil.touchmix2N.global
MercadoLibre	com.mercadolibre
Simple Task Killer	jp.co.aplio.simpletaskkillerfree
Dice With Buddies Free	com.withbuddies.dice.free
My Paper Plane 2 (3D) Full	com.wavecade.mypaperplane_x_lite
Archery	com.innovativeGames.archery
DOOORS - room escape game -	com.kuhakuworks.DOOORS
PPS (for Mobile)	tv.pps.mobile
Bingo Heaven - FREE BINGO GAME	com.twelvegigs.heaven.bingo
Zipcar	com.zc.android
Whispering Sailors	net.sjang.sail
Nova Launcher Prime	com.teslacoilsw.launcher.prime
TeslaLED Flashlight	com.teslacoilsw.flashlight
Moon+ Reader	com.flyersoft.moonreader
Adobe Reader	com.adobe.reader
Voice Search	com.google.android.voicesearch
DEATH DOME	com.glu.ddome
Jeannie (like Siri)	com.pannous.voice.actions.free
Music Download	com.musical.work
Pandora?? internet radio	com.pandora.android
Art Of Glow	com.natenai.artofglow
Where's My Perry?	com.disney.WMP
Temple Run: Brave	com.disney.brave_google
Spades Free	uk.co.aifactory.spadesfree
Endomondo Sports Tracker	com.endomondo.android
ES Task Manager	com.estrongs.android.taskmanager
TouchPal Contacts	com.cootek.smartdialer
Slices for Twitter	com.onelouder.tweetvision
SlenderMan	www.agathasmaze.com.slenderman
TV.com	com.rhythmnewmedia.tvdotcom
Hulu Plus	com.hulu.plus
¨ª??¨¬??¨¬?¡ä¨ª?? ?¡ã¡À¨º3?¨¬??¨¬?? (??¡ä?¡ê?¨¬?¡ä¨ª??/??¡ä?¡ê?¨º2?¨¬??)	com.monaco.dari
Psychological Test For Fun!!	com.dotone.psychologicaltest
QR BARCODE SCANNER	appinventor.ai_progetto2003.SCAN
Voice Recorder	com.tokasiki.android.voicerecorder
Osmos HD	com.hemispheregames.osmos
SPB Shell 3D	com.spb.shell3d
Nova Launcher	com.teslacoilsw.launcher
ClockworkMod Tether (no root)	com.koushikdutta.tether
Killer Bean Unleashed	com.KillerBeanStudios.KillerBeanUnleashed
Apex Launcher	com.anddoes.launcher
Street View on Google Maps	com.google.android.street
TuneWiki - Lyrics for Music	com.tunewiki.lyricplayer.android
App Cache Cleaner	mobi.infolife.cache
TouchPal Keyboard	com.cootek.smartinputv5
VPlayer Video Player	me.abitno.vplayer.t
Granny Smith	com.mediocre.grannysmith
Sex Offender Search	com.fsp.android.h
GPS Tracking Pro	com.fsp.android.c
Easy Battery Saver	com.easy.battery.saver
SiriusXM Internet Radio	com.sirius
Record My Call	com.record.my.call
Call Control - Call Blocker	com.flexaspect.android.everycallcontrol
Kugou Music	com.kugou.android
Soccer / Football Live Scores	com.firstrowria.android.soccerlivescores
Real Soccer 2012	com.gameloft.android.ANMP.GloftS2HM
Scan	me.scan.android.client
Bump	com.bumptech.bumpga
WeatherBug Elite	com.aws.android.elite
AccuWeather for Android	com.accuweather.android
DragonCraft	com.mobage.ww.a567.dragoncraft
Order & Chaos Online	com.gameloft.android.ANMP.GloftMMHM
Antivirus Free	com.zrgiu.antivirus
Talking Gina the Giraffe Free	com.outfit7.talkinggina
Go!Chat Themes Plugin	com.spartanbits.gochat.themes
??????	com.sina.weibo
Photo Editor	com.iudesk.android.photo.editor
Mirror	mmapps.mirror.free
BeFunky Photo Editor	air.com.befunky.BeFunkyPhotoEditor
Can Knockdown	pl.idreams.CanKnockdown
Great Little War Game	com.rubicon.dev.glwg
Toddler Lock	marcone.toddlerlock
Hungry Shark 2 Free!	com.fgol.sharkfree2
Talking Ginger	com.outfit7.talkinggingerfree
CNN App for Android Phones	com.cnn.mobile.android.phone
Hotspot Shield VPN	hotspotshield.android.vpn
WatchESPN	air.WatchESPN
NPR News	org.npr.android.news
Secondary Family Locator	com.life360.android.safetymapa
PhotoWonder	cn.jingling.motu.photowonder
Essential Apps Guide	dr.android.app.lite
Photo FX Live Wallpaper	slide.photoWallpaper
Talking Santa meets Ginger	com.outfit7.talkingsantagingerfree
Amazing Spider-Man 3D Live WP	cellfish.spidermanlwp
adidas EURO 2012 LiveWallpaper	cellfish.adidas
Eurosport.com	com.eurosport
Modern Combat 3: Fallen Nation	com.gameloft.android.ANMP.GloftM3HM
Stand O'Food?? 3	com.g5e.standofood3
Shake Spears!	com.alawar.ShakeSpears
Asphalt 6: Adrenaline	com.gameloft.android.ANMP.GloftA6HP
Ice Age Village	com.gameloft.android.ANMP.GloftIAHM
Six-Guns	com.gameloft.android.ANMP.GloftSXHM
Fishing Diary	com.droidhen.fish
Top Truck Free	com.aceviral.toptruckfree
Road Warrior: Best Racing Game	com.mobjoy.roadwarrior
Texas Poker	com.kamagames.pokerist
Stick Cricket	com.sticksports.stickcricket
Gone Fishing: Trophy Catch	ru.drimmi.fishing2
Movie Quiz	pl.com.szakal.quiz.movies
CONTRACT KILLER: ZOMBIES	com.glu.android.zombsniper_noblood
ZENONIA?? 3	com.gamevil.zenonia3.global
DEER HUNTER RELOADED	com.glu.deerhuntnew
Libra - Weight Manager	net.cachapa.libra
Mp3 Media Converter	com.MediaConverter
aDownloader	com.DroiDownloader
?¡ê?¡¥?1¨´??? ¨´??¡ê?¡ã¨´??¡ì?¡À ?-?¦Ì¨´? ?¡ì¨´?¨´??3¨´?¨´	com.hisn.almuslim
Spotify	com.spotify.mobile.android.ui
Save the Puppies	com.hg.savethepuppiesfree
Papaya Farm	com.papaya.papayaandroidfarm
Papaya Farm 2011	com.papaya.papayafarm2012
Fishing Superstars	com.gamevil.fishing.global
Call of Mini: Zombies	com.trinitigame.callofminiandroid
HD wallpapers (Backgrounds)	com.mudopedia.FreeWallpaper
Manga Searcher | Manga Reader	cn.rtfsc.searchmanga
Prison Escape (Room Escape)	funfungames.prison.escape.room
KPOP STAR	kr.choice
WWE	com.wwe.universe
Phase 10 Free	com.magmic.phase10.lite
adidas miCoach	com.adidas.micoach
Radiant Free	net.hexage.radiant.lite
3BMeteo	com.Meteosolutions.Meteo3b
Sleep as Android	com.urbandroid.sleep
Daum Maps - ??¡è¨¬?? ¨¬¡ì????, ¨¬¡ì?¨ª??¨¬2	net.daum.android.map
LiveScore	com.livescore
Soccer Scores - FotMob	com.mobilefootie.wc2010
Avatar Fortress Fight	funfungames.avatar.fortress.fight
Flick Shoot	net.mobilecraft.football
Logos Quiz	brand.logo
Panda Run	com.Sailfish.PandaRun
OpenTable	com.opentable
Find the Differences / Find ME	find.me.iyc.main
MultiLing Keyboard	com.klye.ime.latin
Awesome Facts	com.awesome.facts
iKamasutra Lite Sex Positions	com.lovekamasutra.ikamasutralite
WoW Droid Armory	com.crocoware.android.wow
Ghost Radar??: CLASSIC	com.spudpickles.grc
Cartoon Camera	com.fingersoft.cartooncamera
Night Vision Camera	com.fingersoft.nightvisioncamera
c:geo	cgeo.geocaching
Music Hub	com.tmobile.apppack
Guitar : Solo Lite	com.codingcaveman.SoloTrial
Yahoo! Sportacular	com.protrade.sportacular
Lucky Bingo	com.luckylabs.luckybingo
Easy Task Killer Advanced	com.mobo.task.killer
Bubble	bz.ktk.bubble
Truecaller - Global directory	com.truecaller
SMS Collection	com.cliqs.smslibrary
Monster Warlord	com.gamevil.monster.global
AREL WARS 2	com.gamevil.ArelWars2.global
Root App Delete (uninstaller)	zsj.android.uninstall
MyTaxRefund by TurboTax a?? Free	com.intuit.mobile.mytaxrefund
Soccer Superstars 2012	com.gamevil.soccer2012.global
Age Of Empire	com.stac.empire.main
The Tribez	com.gameinsight.tribez
Yahoo! Fantasy Football '12	com.yahoo.mobile.client.android.fantasyfootball
AllCallRecorder	androidlab.allcall
F2S Free SMS India	com.free2sms
POPs for SMS Facebook Whatsapp	com.pops.app
ETERNITY WARRIORS	com.glu.android.warriors
Battlefield BF3 Stats	com.bcseime.bf3stats3
Ringo: Ringtones & Text Tones	com.electricpocket.ringo
D¡êD3D¡ãD¡äD¡ãD1 ??D?D?D2D¡ã	com.geoalex.guessword
Top Ringtone Downloader	com.vanke.droidring
Choice of the Dragon	com.choiceofgames.dragon
SMS Unread Count	com.kanokgems.smswidget
Epic Defense a?? the Elements	com.dreamstudio.epicdefense
Crime City	com.funzio.crimecity
Zombie Village	com.roidgame.zombieville
MUTANT ROADKILL	com.glu.wasteland
ETERNITY WARRIORS 2	com.glu.ewarriors2
FRONTLINE COMMANDO	com.glu.modwarsniper
BLOOD & GLORY	com.glu.gladiator
BLOOD & GLORY: LEGEND	com.glu.gladiator2
GEARS & GUTS	com.glu.carszombies
Drop	com.infraredpixel.drop
1-click cleaner	cn.com.opda.android.clearmaster
Akinator the Genie FREE	com.digidust.elokence.akinator.freemium
Pudding Face Match	com.kth.puddingface
Remember The Milk	com.rememberthemilk.MobileRTM
Text Me!  Free Texting & Call	com.textmeinc.textme
Transparent Screen Trial Ver	com.july.freetransparentscreen
Pinterest	com.pinterest
wifiPass	es.sietebit.wifipass
?¡ã?¨¬?¡ä¨ª?1¨¬??¨¬???????? for Kakao	com.ngonsub.VikingIsland
?£¤?????1??¡è¡ì¨¨??2	com.godgame.bigtwo.android
Battery Booster (2x Battery)	com.bb.battery.saver
Kid Mode: Free Games + Lock	com.zoodles.kidmode
¨¬?¡ä¨ª??¨¬?¡è¨ª?????¨¬??¨º¦Ì?2012	com.com2us.bb2012.normal.freefull.google.global.android.common
Mindjet for Android	net.thinkingspace
Taiwan Highway CCTV FREE	com.kny.taiwanfreewaycamviewer
Weaphones: Gun Simulator Free	air.com.oranginalplan.weaphonesfree
CONTRACT KILLER 2	com.glu.contractkiller2
iFighter 1945	com.epicforce.iFighter
Pencil Sketch	com.dumplingsandwich.pencilsketch
SongPop Free	air.com.freshplanet.games.WaM
Better FlashLight HD + LED	torcia.plus
¨¨??¨¨?¡¥?????o??????????????¡§?????????¨¨¡ä¡ä?????????	com.tencent.qqpimsecure
STARDOM: THE A-LIST	com.glu.stardom
Chrome	com.android.chrome
Bible JFA Offline	com.bestweatherfor.bibleoffline_pt_ra
Navfree: Free GPS Navigation	com.navfree.android.OSM.ALL
Enchanted Realm	com.gameinsight.enchantedrealm
Sakura Falling Live Wallpaper	com.reactor.livewallpaper.fallingsakura
CONTRACT KILLER: ZOMBIES (NR)	com.glu.android.zombsniper
Space War Lite	virtualgs.space
3D Need For Speed Racing	cool.top.soft.racing3d
Widgetsoid	com.jim2
justWink Greeting Cards	com.justwink
What's My IQ?a?¡é	com.orangenose.games.whatsmyiq
Poker KinG Online-Texas Holdem	com.geaxgame.pokerking
Slots Journey	com.fishsticksgames.SlotsJourney
Bakery Storya?¡é	com.teamlava.bakerystory
Overkill	com.craneballs.android.overkill
Third Blade	com.com2us.thirdblade.normal.freefull.google.global.android.common
Jawsa?¡é Revenge	com.fusepowered.google.jawsrevenge
Jumpgate Free Live Wallpaper	fishnoodle.jumpgate_free
GREE	jp.gree.android.app
Ninja Fishing	com.gamenauts.ninjafishingfull
Paladog Free	com.Paladog.KorGG.Lite
TOY VILLAGE	com.glu.toyvillage
Logos Quiz	com.quizlogo
iBasket	com.ideateca.android.ibasket
Google Pinyin IME	com.google.android.inputmethod.pinyin
Ulysse Speedometer	com.binarytoys.speedometer
D?D¡äD?D?DoD?D¡ã????D?D?DoD?	ru.ok.android
Dragonplay Widget	com.dragonplay.widget
Mood Scanner	com.dikkar.moodscanner
IMoNi	net.grandnature.android.imodenotifier
Call Blocker	com.netqin.mm
Ninesky Browser	com.ninesky.browser
Stunt Car Challenge	com.hyperkani.stuntcarchallenge
Slice Ice!	com.hyperkani.sliceice
Agent Dash	com.fullfat.android.agentdash
Police Scanner FREE	com.criticalhitsoftware.policeradio
Wiki Encyclopedia & Newspapers	uk.co.exelentia.wikipedia
Ultimate Logo Quiz	logo.quiz.game.category
Scare Your Friends - SHOCK!	scare.your.friends.prank.maze.halloween
Logo Quiz - Cars	logo.quiz.car.game
Logo Quiz - Music Bands	logo.quiz.music.bands.game
WEB.DE Mail	de.web.mobile.android.mail
Epocrates	com.epocrates
Brothers In Arms?? 2 Free+	com.gameloft.android.ANMP.GloftB2HM
??¡è¨¬?¡ä?2? ¨¬?1¨ª?¡ã - Naver Webtoon	com.nhn.android.webtoon
¨º??????|? ¨¬?????¨¬??	com.korail.korail
??¡ä¨º¡ã?¨º¡¤??|¡ã ¨º?¡ã?|¡ã¨º¡¤??|? for Kakao	com.awesomepiece.sketchbook
¨º¡ã????¨¬????? ??¡À?¡ì??¡ì?¨¬??¨º?¡ã	com.abluewind.garosero
¨¬??¨º?¡ã???¨¬?¡§	wongi.weather
¨ª?¡ä¨¬|? ??¡ä¨ª?????¨¬?? - Qube ¨ª?¡ä¨¬|?¨ª?????	com.shift.quiz.infinite
[??¡ä?¡ê?] ¨ª??¨º2?¨¬?? ¨¬??¨¬2?¨¬?¡À	com.nhncorp.Mahjong
¨ª??¨º2?¨¬?? ¨¬2¡ä¨¬??¨¬¡ì?¨ª??¨ª??	com.nhncorp.cppang
AIVC (Alice)	yourapp24.android.tools.alice_lite
Moai Slots	com.moaibot.moaislots
Full HD wallpapers	com.iconnect.app.pts
Real Steel Free	com.jumpgames.RealSteelFreeEdtion
Super Task Killer FREE	com.netqin.aotkiller
Funny Camera	com.tndev.funnyframes
Whack Your Teacher 18+	com.box10.dontwhackyourteacher
Marktplaats	nl.marktplaats.android
Lep's World	at.nerbrothers.SuperJump
Amazing Broken Display	eu.softwareworkshop.brokenscreen
SWF Player - Flash ??FileViewer	com.issess.flashplayer
Sniper shot!	ru.coder1cv8.sniper
Prince of Persia Classic Free	org.ubisoft.freemium.POPClassic
Gun & Blood	com.feelingtouch.strikeforce
Magic Tree by Com2uS	com.com2us.magictree.normal.freefull.google.global.android.common
Cricket T20 Fever 3D	com.indiagames.cricketfever
Japan Life	com.nubee.japanlife
Animal Collections	com.nubee.animalcollections
Pou	me.pou.app
Baams Away!	com.beardedEye.baamsAway
Bounce Classic	com.cbaus.bounce
Babel Rising 3D!	com.mando.babelrising3dfreemium
GnarBike Trials	com.GnarlyGames.GnarBikeTrials
Gun Strike	com.paladin.GunStrike
Bridge Constructor FREE	com.headupgames.bridgeconstructorfreeversion
Android Booster FREE	com.netqin.mobileguard
NQ Mobile Security & Antivirus	com.nqmobile.antivirus20
RockPlayer Lite	com.redirectin.rockplayer.android.unified.lite
UC?¦Ì?¨¨¡ì???¡§ 8.7?-¡ê??????	com.UCMobile
Cricket WorldCup Fever	com.indiagames.cricketworldcup
??ffi - Public Transport Buddy	de.schildbach.oeffi
TurboTax SnapTax	com.intuit.instantreturn
Liga (League) Argentina	ar.com.kinetia.ligaargentina
Slime vs. Mushroom	com.westriversw.svsm
¨¬?????¨ª?? for Kakao	com.sundaytoz.mobile.anipang.google.service
Minecraft Canary Guide	com.ninjacoders.mcanary
Tic Tac Toe - Pro	com.tictactoe.wintrino
London 2012-OfficialGame(free)	com.nwi.london2012
????¡¤??a???? Gun Strike?1???-???	com.paladin.GunStrikeTW
Soldiers of Glory: Modern War	com.catstudio.sogmw
Soldiers of Glory: WW2 Free	com.catstudio.soldierofgloryfree
100 Missions	com.mpisoft.spymissions
NFL Pro 2013	com.gameloft.android.ANMP.GloftF3HM
??¡é?1??????¡ã???	com.apponly.landlords
¨ª??¨¬|? ¨¬¡ê?¨¬¡ê? for Kakao	com.nexon.zi
Learn English with babbel.com	com.babbel.mobile.android.en
Fruit Devil	com.feelingtouch.xrush
Super Bubble Birds	com.ximad.bubble_birds2_free
Dungeon Hunter 3	com.gameloft.android.ANMP.GloftD3HM
Arcane Empires	com.kabam.arcaneempires
World of Warcraft Armory	com.blizzard.wow
T-Mobile Visual Voicemail	com.tmobile.vvm.application
MP3 Music Download V6	free.mp3.dlv6
NateOn UC	Uxpp.UC
